Customer ID,Billing Start Date,Billing End Date,Previous Meter Reading,Current Meter Reading,Usage (kWh),Total Charge
1000,2023-01-01,2023-01-31,1454,1689,235,35.25
1000,2023-02-01,2023-03-03,1689,1849,160,24.0
1000,2023-03-01,2023-03-31,1849,2192,343,51.45
1000,2023-04-01,2023-05-01,2192,2459,267,40.05
1000,2023-05-01,2023-05-31,2459,2901,442,66.3
1000,2023-06-01,2023-07-01,2901,3122,221,33.15
1000,2023-07-01,2023-07-31,3122,3313,191,28.65
1000,2023-08-01,2023-08-31,3313,3450,137,20.55
1000,2023-09-01,2023-10-01,3450,3703,253,37.95
1000,2023-10-01,2023-10-31,3703,3824,121,18.15
1000,2023-11-01,2023-12-01,3824,4123,299,44.85
1000,2023-12-01,2023-12-31,4123,4556,433,64.95
1001,2023-01-01,2023-01-31,3556,3969,413,61.95
1001,2023-02-01,2023-03-03,3969,4087,118,17.7
1001,2023-03-01,2023-03-31,4087,4270,183,27.45
1001,2023-04-01,2023-05-01,4270,4574,304,45.6
1001,2023-05-01,2023-05-31,4574,4793,219,32.85
1001,2023-06-01,2023-07-01,4793,5012,219,32.85
1001,2023-07-01,2023-07-31,5012,5355,343,51.45
1001,2023-08-01,2023-08-31,5355,5646,291,43.65
1001,2023-09-01,2023-10-01,5646,6060,414,62.1
1001,2023-10-01,2023-10-31,6060,6267,207,31.05
1001,2023-11-01,2023-12-01,6267,6761,494,74.1
1001,2023-12-01,2023-12-31,6761,7198,437,65.55
1002,2023-01-01,2023-01-31,4853,5073,220,33.0
1002,2023-02-01,2023-03-03,5073,5358,285,42.75
1002,2023-03-01,2023-03-31,5358,5590,232,34.8
1002,2023-04-01,2023-05-01,5590,5715,125,18.75
1002,2023-05-01,2023-05-31,5715,6199,484,72.6
1002,2023-06-01,2023-07-01,6199,6519,320,48.0
1002,2023-07-01,2023-07-31,6519,6934,415,62.25
1002,2023-08-01,2023-08-31,6934,7297,363,54.45
1002,2023-09-01,2023-10-01,7297,7603,306,45.9
1002,2023-10-01,2023-10-31,7603,7696,93,13.95
1002,2023-11-01,2023-12-01,7696,8123,427,64.05
1002,2023-12-01,2023-12-31,8123,8533,410,61.5
1003,2023-01-01,2023-01-31,1277,1333,56,8.4
1003,2023-02-01,2023-03-03,1333,1640,307,46.05
1003,2023-03-01,2023-03-31,1640,1968,328,49.2
1003,2023-04-01,2023-05-01,1968,2370,402,60.3
1003,2023-05-01,2023-05-31,2370,2596,226,33.9
1003,2023-06-01,2023-07-01,2596,2835,239,35.85
1003,2023-07-01,2023-07-31,2835,3266,431,64.65
1003,2023-08-01,2023-08-31,3266,3481,215,32.25
1003,2023-09-01,2023-10-01,3481,3600,119,17.85
1003,2023-10-01,2023-10-31,3600,3692,92,13.8
1003,2023-11-01,2023-12-01,3692,3809,117,17.55
1003,2023-12-01,2023-12-31,3809,4278,469,70.35
1004,2023-01-01,2023-01-31,1505,1775,270,40.5
1004,2023-02-01,2023-03-03,1775,1971,196,29.4
1004,2023-03-01,2023-03-31,1971,2406,435,65.25
1004,2023-04-01,2023-05-01,2406,2627,221,33.15
1004,2023-05-01,2023-05-31,2627,2737,110,16.5
1004,2023-06-01,2023-07-01,2737,3204,467,70.05
1004,2023-07-01,2023-07-31,3204,3484,280,42.0
1004,2023-08-01,2023-08-31,3484,3546,62,9.3
1004,2023-09-01,2023-10-01,3546,3638,92,13.8
1004,2023-10-01,2023-10-31,3638,4123,485,72.75
1004,2023-11-01,2023-12-01,4123,4490,367,55.05
1004,2023-12-01,2023-12-31,4490,4606,116,17.4
1005,2023-01-01,2023-01-31,4370,4447,77,11.55
1005,2023-02-01,2023-03-03,4447,4798,351,52.65
1005,2023-03-01,2023-03-31,4798,4892,94,14.1
1005,2023-04-01,2023-05-01,4892,5106,214,32.1
1005,2023-05-01,2023-05-31,5106,5394,288,43.2
1005,2023-06-01,2023-07-01,5394,5755,361,54.15
1005,2023-07-01,2023-07-31,5755,6077,322,48.3
1005,2023-08-01,2023-08-31,6077,6514,437,65.55
1005,2023-09-01,2023-10-01,6514,6674,160,24.0
1005,2023-10-01,2023-10-31,6674,6844,170,25.5
1005,2023-11-01,2023-12-01,6844,7067,223,33.45
1005,2023-12-01,2023-12-31,7067,7542,475,71.25
1006,2023-01-01,2023-01-31,1654,2136,482,72.3
1006,2023-02-01,2023-03-03,2136,2456,320,48.0
1006,2023-03-01,2023-03-31,2456,2820,364,54.6
1006,2023-04-01,2023-05-01,2820,3149,329,49.35
1006,2023-05-01,2023-05-31,3149,3218,69,10.35
1006,2023-06-01,2023-07-01,3218,3512,294,44.1
1006,2023-07-01,2023-07-31,3512,3856,344,51.6
1006,2023-08-01,2023-08-31,3856,3943,87,13.05
1006,2023-09-01,2023-10-01,3943,4433,490,73.5
1006,2023-10-01,2023-10-31,4433,4542,109,16.35
1006,2023-11-01,2023-12-01,4542,4984,442,66.3
1006,2023-12-01,2023-12-31,4984,5053,69,10.35
1007,2023-01-01,2023-01-31,2094,2339,245,36.75
1007,2023-02-01,2023-03-03,2339,2419,80,12.0
1007,2023-03-01,2023-03-31,2419,2908,489,73.35
1007,2023-04-01,2023-05-01,2908,3037,129,19.35
1007,2023-05-01,2023-05-31,3037,3125,88,13.2
1007,2023-06-01,2023-07-01,3125,3404,279,41.85
1007,2023-07-01,2023-07-31,3404,3601,197,29.55
1007,2023-08-01,2023-08-31,3601,4084,483,72.45
1007,2023-09-01,2023-10-01,4084,4486,402,60.3
1007,2023-10-01,2023-10-31,4486,4817,331,49.65
1007,2023-11-01,2023-12-01,4817,4886,69,10.35
1007,2023-12-01,2023-12-31,4886,5283,397,59.55
1008,2023-01-01,2023-01-31,2524,2822,298,44.7
1008,2023-02-01,2023-03-03,2822,2886,64,9.6
1008,2023-03-01,2023-03-31,2886,3219,333,49.95
1008,2023-04-01,2023-05-01,3219,3372,153,22.95
1008,2023-05-01,2023-05-31,3372,3868,496,74.4
1008,2023-06-01,2023-07-01,3868,4130,262,39.3
1008,2023-07-01,2023-07-31,4130,4285,155,23.25
1008,2023-08-01,2023-08-31,4285,4446,161,24.15
1008,2023-09-01,2023-10-01,4446,4798,352,52.8
1008,2023-10-01,2023-10-31,4798,4897,99,14.85
1008,2023-11-01,2023-12-01,4897,5088,191,28.65
1008,2023-12-01,2023-12-31,5088,5558,470,70.5
1009,2023-01-01,2023-01-31,3430,3589,159,23.85
1009,2023-02-01,2023-03-03,3589,4067,478,71.7
1009,2023-03-01,2023-03-31,4067,4478,411,61.65
1009,2023-04-01,2023-05-01,4478,4583,105,15.75
1009,2023-05-01,2023-05-31,4583,4935,352,52.8
1009,2023-06-01,2023-07-01,4935,5257,322,48.3
1009,2023-07-01,2023-07-31,5257,5331,74,11.1
1009,2023-08-01,2023-08-31,5331,5770,439,65.85
1009,2023-09-01,2023-10-01,5770,6059,289,43.35
1009,2023-10-01,2023-10-31,6059,6370,311,46.65
1009,2023-11-01,2023-12-01,6370,6866,496,74.4
1009,2023-12-01,2023-12-31,6866,7357,491,73.65
1010,2023-01-01,2023-01-31,1618,1850,232,34.8
1010,2023-02-01,2023-03-03,1850,2153,303,45.45
1010,2023-03-01,2023-03-31,2153,2601,448,67.2
1010,2023-04-01,2023-05-01,2601,2821,220,33.0
1010,2023-05-01,2023-05-31,2821,3045,224,33.6
1010,2023-06-01,2023-07-01,3045,3283,238,35.7
1010,2023-07-01,2023-07-31,3283,3654,371,55.65
1010,2023-08-01,2023-08-31,3654,4153,499,74.85
1010,2023-09-01,2023-10-01,4153,4627,474,71.1
1010,2023-10-01,2023-10-31,4627,4795,168,25.2
1010,2023-11-01,2023-12-01,4795,4987,192,28.8
1010,2023-12-01,2023-12-31,4987,5377,390,58.5
1011,2023-01-01,2023-01-31,2430,2886,456,68.4
1011,2023-02-01,2023-03-03,2886,3138,252,37.8
1011,2023-03-01,2023-03-31,3138,3590,452,67.8
1011,2023-04-01,2023-05-01,3590,3705,115,17.25
1011,2023-05-01,2023-05-31,3705,3864,159,23.85
1011,2023-06-01,2023-07-01,3864,4102,238,35.7
1011,2023-07-01,2023-07-31,4102,4493,391,58.65
1011,2023-08-01,2023-08-31,4493,4564,71,10.65
1011,2023-09-01,2023-10-01,4564,4945,381,57.15
1011,2023-10-01,2023-10-31,4945,5032,87,13.05
1011,2023-11-01,2023-12-01,5032,5287,255,38.25
1011,2023-12-01,2023-12-31,5287,5763,476,71.4
1012,2023-01-01,2023-01-31,3147,3442,295,44.25
1012,2023-02-01,2023-03-03,3442,3710,268,40.2
1012,2023-03-01,2023-03-31,3710,4132,422,63.3
1012,2023-04-01,2023-05-01,4132,4493,361,54.15
1012,2023-05-01,2023-05-31,4493,4621,128,19.2
1012,2023-06-01,2023-07-01,4621,4954,333,49.95
1012,2023-07-01,2023-07-31,4954,5252,298,44.7
1012,2023-08-01,2023-08-31,5252,5729,477,71.55
1012,2023-09-01,2023-10-01,5729,6145,416,62.4
1012,2023-10-01,2023-10-31,6145,6533,388,58.2
1012,2023-11-01,2023-12-01,6533,6915,382,57.3
1012,2023-12-01,2023-12-31,6915,7241,326,48.9
1013,2023-01-01,2023-01-31,4566,4616,50,7.5
1013,2023-02-01,2023-03-03,4616,4837,221,33.15
1013,2023-03-01,2023-03-31,4837,5332,495,74.25
1013,2023-04-01,2023-05-01,5332,5388,56,8.4
1013,2023-05-01,2023-05-31,5388,5841,453,67.95
1013,2023-06-01,2023-07-01,5841,6027,186,27.9
1013,2023-07-01,2023-07-31,6027,6093,66,9.9
1013,2023-08-01,2023-08-31,6093,6512,419,62.85
1013,2023-09-01,2023-10-01,6512,6562,50,7.5
1013,2023-10-01,2023-10-31,6562,7045,483,72.45
1013,2023-11-01,2023-12-01,7045,7461,416,62.4
1013,2023-12-01,2023-12-31,7461,7847,386,57.9
1014,2023-01-01,2023-01-31,3362,3715,353,52.95
1014,2023-02-01,2023-03-03,3715,3957,242,36.3
1014,2023-03-01,2023-03-31,3957,4233,276,41.4
1014,2023-04-01,2023-05-01,4233,4349,116,17.4
1014,2023-05-01,2023-05-31,4349,4653,304,45.6
1014,2023-06-01,2023-07-01,4653,4815,162,24.3
1014,2023-07-01,2023-07-31,4815,4867,52,7.8
1014,2023-08-01,2023-08-31,4867,5101,234,35.1
1014,2023-09-01,2023-10-01,5101,5263,162,24.3
1014,2023-10-01,2023-10-31,5263,5534,271,40.65
1014,2023-11-01,2023-12-01,5534,5845,311,46.65
1014,2023-12-01,2023-12-31,5845,6215,370,55.5
1015,2023-01-01,2023-01-31,1628,2121,493,73.95
1015,2023-02-01,2023-03-03,2121,2490,369,55.35
1015,2023-03-01,2023-03-31,2490,2824,334,50.1
1015,2023-04-01,2023-05-01,2824,3031,207,31.05
1015,2023-05-01,2023-05-31,3031,3487,456,68.4
1015,2023-06-01,2023-07-01,3487,3786,299,44.85
1015,2023-07-01,2023-07-31,3786,4276,490,73.5
1015,2023-08-01,2023-08-31,4276,4385,109,16.35
1015,2023-09-01,2023-10-01,4385,4511,126,18.9
1015,2023-10-01,2023-10-31,4511,4976,465,69.75
1015,2023-11-01,2023-12-01,4976,5314,338,50.7
1015,2023-12-01,2023-12-31,5314,5568,254,38.1
1016,2023-01-01,2023-01-31,3618,3789,171,25.65
1016,2023-02-01,2023-03-03,3789,4031,242,36.3
1016,2023-03-01,2023-03-31,4031,4324,293,43.95
1016,2023-04-01,2023-05-01,4324,4753,429,64.35
1016,2023-05-01,2023-05-31,4753,4985,232,34.8
1016,2023-06-01,2023-07-01,4985,5210,225,33.75
1016,2023-07-01,2023-07-31,5210,5548,338,50.7
1016,2023-08-01,2023-08-31,5548,5906,358,53.7
1016,2023-09-01,2023-10-01,5906,6293,387,58.05
1016,2023-10-01,2023-10-31,6293,6524,231,34.65
1016,2023-11-01,2023-12-01,6524,6843,319,47.85
1016,2023-12-01,2023-12-31,6843,7335,492,73.8
1017,2023-01-01,2023-01-31,3604,3751,147,22.05
1017,2023-02-01,2023-03-03,3751,3998,247,37.05
1017,2023-03-01,2023-03-31,3998,4336,338,50.7
1017,2023-04-01,2023-05-01,4336,4504,168,25.2
1017,2023-05-01,2023-05-31,4504,4605,101,15.15
1017,2023-06-01,2023-07-01,4605,4990,385,57.75
1017,2023-07-01,2023-07-31,4990,5398,408,61.2
1017,2023-08-01,2023-08-31,5398,5842,444,66.6
1017,2023-09-01,2023-10-01,5842,6159,317,47.55
1017,2023-10-01,2023-10-31,6159,6351,192,28.8
1017,2023-11-01,2023-12-01,6351,6758,407,61.05
1017,2023-12-01,2023-12-31,6758,6979,221,33.15
1018,2023-01-01,2023-01-31,2095,2262,167,25.05
1018,2023-02-01,2023-03-03,2262,2424,162,24.3
1018,2023-03-01,2023-03-31,2424,2546,122,18.3
1018,2023-04-01,2023-05-01,2546,2756,210,31.5
1018,2023-05-01,2023-05-31,2756,3205,449,67.35
1018,2023-06-01,2023-07-01,3205,3512,307,46.05
1018,2023-07-01,2023-07-31,3512,3852,340,51.0
1018,2023-08-01,2023-08-31,3852,3983,131,19.65
1018,2023-09-01,2023-10-01,3983,4461,478,71.7
1018,2023-10-01,2023-10-31,4461,4884,423,63.45
1018,2023-11-01,2023-12-01,4884,5343,459,68.85
1018,2023-12-01,2023-12-31,5343,5827,484,72.6
1019,2023-01-01,2023-01-31,1287,1712,425,63.75
1019,2023-02-01,2023-03-03,1712,2064,352,52.8
1019,2023-03-01,2023-03-31,2064,2340,276,41.4
1019,2023-04-01,2023-05-01,2340,2397,57,8.55
1019,2023-05-01,2023-05-31,2397,2514,117,17.55
1019,2023-06-01,2023-07-01,2514,2777,263,39.45
1019,2023-07-01,2023-07-31,2777,2875,98,14.7
1019,2023-08-01,2023-08-31,2875,2932,57,8.55
1019,2023-09-01,2023-10-01,2932,3005,73,10.95
1019,2023-10-01,2023-10-31,3005,3111,106,15.9
1019,2023-11-01,2023-12-01,3111,3585,474,71.1
1019,2023-12-01,2023-12-31,3585,3902,317,47.55
1020,2023-01-01,2023-01-31,2007,2461,454,68.1
1020,2023-02-01,2023-03-03,2461,2565,104,15.6
1020,2023-03-01,2023-03-31,2565,2859,294,44.1
1020,2023-04-01,2023-05-01,2859,3177,318,47.7
1020,2023-05-01,2023-05-31,3177,3241,64,9.6
1020,2023-06-01,2023-07-01,3241,3731,490,73.5
1020,2023-07-01,2023-07-31,3731,4030,299,44.85
1020,2023-08-01,2023-08-31,4030,4494,464,69.6
1020,2023-09-01,2023-10-01,4494,4698,204,30.6
1020,2023-10-01,2023-10-31,4698,5065,367,55.05
1020,2023-11-01,2023-12-01,5065,5441,376,56.4
1020,2023-12-01,2023-12-31,5441,5503,62,9.3
1021,2023-01-01,2023-01-31,4019,4423,404,60.6
1021,2023-02-01,2023-03-03,4423,4584,161,24.15
1021,2023-03-01,2023-03-31,4584,5001,417,62.55
1021,2023-04-01,2023-05-01,5001,5275,274,41.1
1021,2023-05-01,2023-05-31,5275,5417,142,21.3
1021,2023-06-01,2023-07-01,5417,5884,467,70.05
1021,2023-07-01,2023-07-31,5884,6025,141,21.15
1021,2023-08-01,2023-08-31,6025,6212,187,28.05
1021,2023-09-01,2023-10-01,6212,6359,147,22.05
1021,2023-10-01,2023-10-31,6359,6623,264,39.6
1021,2023-11-01,2023-12-01,6623,6948,325,48.75
1021,2023-12-01,2023-12-31,6948,7038,90,13.5
1022,2023-01-01,2023-01-31,1409,1677,268,40.2
1022,2023-02-01,2023-03-03,1677,2077,400,60.0
1022,2023-03-01,2023-03-31,2077,2280,203,30.45
1022,2023-04-01,2023-05-01,2280,2682,402,60.3
1022,2023-05-01,2023-05-31,2682,2742,60,9.0
1022,2023-06-01,2023-07-01,2742,3239,497,74.55
1022,2023-07-01,2023-07-31,3239,3423,184,27.6
1022,2023-08-01,2023-08-31,3423,3504,81,12.15
1022,2023-09-01,2023-10-01,3504,3626,122,18.3
1022,2023-10-01,2023-10-31,3626,4029,403,60.45
1022,2023-11-01,2023-12-01,4029,4244,215,32.25
1022,2023-12-01,2023-12-31,4244,4584,340,51.0
1023,2023-01-01,2023-01-31,3719,3878,159,23.85
1023,2023-02-01,2023-03-03,3878,4247,369,55.35
1023,2023-03-01,2023-03-31,4247,4394,147,22.05
1023,2023-04-01,2023-05-01,4394,4584,190,28.5
1023,2023-05-01,2023-05-31,4584,4648,64,9.6
1023,2023-06-01,2023-07-01,4648,4840,192,28.8
1023,2023-07-01,2023-07-31,4840,4964,124,18.6
1023,2023-08-01,2023-08-31,4964,5331,367,55.05
1023,2023-09-01,2023-10-01,5331,5789,458,68.7
1023,2023-10-01,2023-10-31,5789,6179,390,58.5
1023,2023-11-01,2023-12-01,6179,6487,308,46.2
1023,2023-12-01,2023-12-31,6487,6740,253,37.95
1024,2023-01-01,2023-01-31,4688,4848,160,24.0
1024,2023-02-01,2023-03-03,4848,5076,228,34.2
1024,2023-03-01,2023-03-31,5076,5555,479,71.85
1024,2023-04-01,2023-05-01,5555,5967,412,61.8
1024,2023-05-01,2023-05-31,5967,6452,485,72.75
1024,2023-06-01,2023-07-01,6452,6776,324,48.6
1024,2023-07-01,2023-07-31,6776,6967,191,28.65
1024,2023-08-01,2023-08-31,6967,7158,191,28.65
1024,2023-09-01,2023-10-01,7158,7535,377,56.55
1024,2023-10-01,2023-10-31,7535,7808,273,40.95
1024,2023-11-01,2023-12-01,7808,7956,148,22.2
1024,2023-12-01,2023-12-31,7956,8138,182,27.3
1025,2023-01-01,2023-01-31,2829,3094,265,39.75
1025,2023-02-01,2023-03-03,3094,3406,312,46.8
1025,2023-03-01,2023-03-31,3406,3505,99,14.85
1025,2023-04-01,2023-05-01,3505,3844,339,50.85
1025,2023-05-01,2023-05-31,3844,4309,465,69.75
1025,2023-06-01,2023-07-01,4309,4613,304,45.6
1025,2023-07-01,2023-07-31,4613,4980,367,55.05
1025,2023-08-01,2023-08-31,4980,5377,397,59.55
1025,2023-09-01,2023-10-01,5377,5793,416,62.4
1025,2023-10-01,2023-10-31,5793,5994,201,30.15
1025,2023-11-01,2023-12-01,5994,6088,94,14.1
1025,2023-12-01,2023-12-31,6088,6553,465,69.75
1026,2023-01-01,2023-01-31,1652,1966,314,47.1
1026,2023-02-01,2023-03-03,1966,2041,75,11.25
1026,2023-03-01,2023-03-31,2041,2174,133,19.95
1026,2023-04-01,2023-05-01,2174,2272,98,14.7
1026,2023-05-01,2023-05-31,2272,2341,69,10.35
1026,2023-06-01,2023-07-01,2341,2436,95,14.25
1026,2023-07-01,2023-07-31,2436,2918,482,72.3
1026,2023-08-01,2023-08-31,2918,3223,305,45.75
1026,2023-09-01,2023-10-01,3223,3612,389,58.35
1026,2023-10-01,2023-10-31,3612,3874,262,39.3
1026,2023-11-01,2023-12-01,3874,3963,89,13.35
1026,2023-12-01,2023-12-31,3963,4127,164,24.6
1027,2023-01-01,2023-01-31,2805,3012,207,31.05
1027,2023-02-01,2023-03-03,3012,3451,439,65.85
1027,2023-03-01,2023-03-31,3451,3664,213,31.95
1027,2023-04-01,2023-05-01,3664,3916,252,37.8
1027,2023-05-01,2023-05-31,3916,3967,51,7.65
1027,2023-06-01,2023-07-01,3967,4172,205,30.75
1027,2023-07-01,2023-07-31,4172,4496,324,48.6
1027,2023-08-01,2023-08-31,4496,4947,451,67.65
1027,2023-09-01,2023-10-01,4947,5327,380,57.0
1027,2023-10-01,2023-10-31,5327,5647,320,48.0
1027,2023-11-01,2023-12-01,5647,6017,370,55.5
1027,2023-12-01,2023-12-31,6017,6379,362,54.3
1028,2023-01-01,2023-01-31,4197,4665,468,70.2
1028,2023-02-01,2023-03-03,4665,4856,191,28.65
1028,2023-03-01,2023-03-31,4856,5199,343,51.45
1028,2023-04-01,2023-05-01,5199,5533,334,50.1
1028,2023-05-01,2023-05-31,5533,5902,369,55.35
1028,2023-06-01,2023-07-01,5902,6234,332,49.8
1028,2023-07-01,2023-07-31,6234,6570,336,50.4
1028,2023-08-01,2023-08-31,6570,6712,142,21.3
1028,2023-09-01,2023-10-01,6712,6981,269,40.35
1028,2023-10-01,2023-10-31,6981,7466,485,72.75
1028,2023-11-01,2023-12-01,7466,7545,79,11.85
1028,2023-12-01,2023-12-31,7545,7711,166,24.9
1029,2023-01-01,2023-01-31,3116,3281,165,24.75
1029,2023-02-01,2023-03-03,3281,3550,269,40.35
1029,2023-03-01,2023-03-31,3550,3721,171,25.65
1029,2023-04-01,2023-05-01,3721,4150,429,64.35
1029,2023-05-01,2023-05-31,4150,4541,391,58.65
1029,2023-06-01,2023-07-01,4541,5030,489,73.35
1029,2023-07-01,2023-07-31,5030,5216,186,27.9
1029,2023-08-01,2023-08-31,5216,5339,123,18.45
1029,2023-09-01,2023-10-01,5339,5426,87,13.05
1029,2023-10-01,2023-10-31,5426,5477,51,7.65
1029,2023-11-01,2023-12-01,5477,5954,477,71.55
1029,2023-12-01,2023-12-31,5954,6181,227,34.05
1030,2023-01-01,2023-01-31,3795,4142,347,52.05
1030,2023-02-01,2023-03-03,4142,4378,236,35.4
1030,2023-03-01,2023-03-31,4378,4646,268,40.2
1030,2023-04-01,2023-05-01,4646,4849,203,30.45
1030,2023-05-01,2023-05-31,4849,5050,201,30.15
1030,2023-06-01,2023-07-01,5050,5333,283,42.45
1030,2023-07-01,2023-07-31,5333,5753,420,63.0
1030,2023-08-01,2023-08-31,5753,6061,308,46.2
1030,2023-09-01,2023-10-01,6061,6245,184,27.6
1030,2023-10-01,2023-10-31,6245,6578,333,49.95
1030,2023-11-01,2023-12-01,6578,6647,69,10.35
1030,2023-12-01,2023-12-31,6647,6798,151,22.65
1031,2023-01-01,2023-01-31,1551,1889,338,50.7
1031,2023-02-01,2023-03-03,1889,2018,129,19.35
1031,2023-03-01,2023-03-31,2018,2499,481,72.15
1031,2023-04-01,2023-05-01,2499,2611,112,16.8
1031,2023-05-01,2023-05-31,2611,2732,121,18.15
1031,2023-06-01,2023-07-01,2732,3205,473,70.95
1031,2023-07-01,2023-07-31,3205,3346,141,21.15
1031,2023-08-01,2023-08-31,3346,3543,197,29.55
1031,2023-09-01,2023-10-01,3543,3737,194,29.1
1031,2023-10-01,2023-10-31,3737,4099,362,54.3
1031,2023-11-01,2023-12-01,4099,4469,370,55.5
1031,2023-12-01,2023-12-31,4469,4546,77,11.55
1032,2023-01-01,2023-01-31,1286,1773,487,73.05
1032,2023-02-01,2023-03-03,1773,2232,459,68.85
1032,2023-03-01,2023-03-31,2232,2680,448,67.2
1032,2023-04-01,2023-05-01,2680,2937,257,38.55
1032,2023-05-01,2023-05-31,2937,3357,420,63.0
1032,2023-06-01,2023-07-01,3357,3717,360,54.0
1032,2023-07-01,2023-07-31,3717,4044,327,49.05
1032,2023-08-01,2023-08-31,4044,4310,266,39.9
1032,2023-09-01,2023-10-01,4310,4562,252,37.8
1032,2023-10-01,2023-10-31,4562,5024,462,69.3
1032,2023-11-01,2023-12-01,5024,5172,148,22.2
1032,2023-12-01,2023-12-31,5172,5257,85,12.75
1033,2023-01-01,2023-01-31,1060,1301,241,36.15
1033,2023-02-01,2023-03-03,1301,1372,71,10.65
1033,2023-03-01,2023-03-31,1372,1753,381,57.15
1033,2023-04-01,2023-05-01,1753,2112,359,53.85
1033,2023-05-01,2023-05-31,2112,2466,354,53.1
1033,2023-06-01,2023-07-01,2466,2642,176,26.4
1033,2023-07-01,2023-07-31,2642,2990,348,52.2
1033,2023-08-01,2023-08-31,2990,3162,172,25.8
1033,2023-09-01,2023-10-01,3162,3398,236,35.4
1033,2023-10-01,2023-10-31,3398,3787,389,58.35
1033,2023-11-01,2023-12-01,3787,4008,221,33.15
1033,2023-12-01,2023-12-31,4008,4423,415,62.25
1034,2023-01-01,2023-01-31,1679,2001,322,48.3
1034,2023-02-01,2023-03-03,2001,2291,290,43.5
1034,2023-03-01,2023-03-31,2291,2620,329,49.35
1034,2023-04-01,2023-05-01,2620,3067,447,67.05
1034,2023-05-01,2023-05-31,3067,3290,223,33.45
1034,2023-06-01,2023-07-01,3290,3769,479,71.85
1034,2023-07-01,2023-07-31,3769,4219,450,67.5
1034,2023-08-01,2023-08-31,4219,4387,168,25.2
1034,2023-09-01,2023-10-01,4387,4454,67,10.05
1034,2023-10-01,2023-10-31,4454,4601,147,22.05
1034,2023-11-01,2023-12-01,4601,4716,115,17.25
1034,2023-12-01,2023-12-31,4716,5101,385,57.75
1035,2023-01-01,2023-01-31,1552,1650,98,14.7
1035,2023-02-01,2023-03-03,1650,1894,244,36.6
1035,2023-03-01,2023-03-31,1894,1999,105,15.75
1035,2023-04-01,2023-05-01,1999,2338,339,50.85
1035,2023-05-01,2023-05-31,2338,2388,50,7.5
1035,2023-06-01,2023-07-01,2388,2881,493,73.95
1035,2023-07-01,2023-07-31,2881,3346,465,69.75
1035,2023-08-01,2023-08-31,3346,3558,212,31.8
1035,2023-09-01,2023-10-01,3558,3692,134,20.1
1035,2023-10-01,2023-10-31,3692,3792,100,15.0
1035,2023-11-01,2023-12-01,3792,3934,142,21.3
1035,2023-12-01,2023-12-31,3934,4377,443,66.45
1036,2023-01-01,2023-01-31,1654,1811,157,23.55
1036,2023-02-01,2023-03-03,1811,1901,90,13.5
1036,2023-03-01,2023-03-31,1901,2041,140,21.0
1036,2023-04-01,2023-05-01,2041,2438,397,59.55
1036,2023-05-01,2023-05-31,2438,2646,208,31.2
1036,2023-06-01,2023-07-01,2646,3057,411,61.65
1036,2023-07-01,2023-07-31,3057,3234,177,26.55
1036,2023-08-01,2023-08-31,3234,3456,222,33.3
1036,2023-09-01,2023-10-01,3456,3781,325,48.75
1036,2023-10-01,2023-10-31,3781,4022,241,36.15
1036,2023-11-01,2023-12-01,4022,4111,89,13.35
1036,2023-12-01,2023-12-31,4111,4384,273,40.95
1037,2023-01-01,2023-01-31,4546,4767,221,33.15
1037,2023-02-01,2023-03-03,4767,4842,75,11.25
1037,2023-03-01,2023-03-31,4842,5157,315,47.25
1037,2023-04-01,2023-05-01,5157,5413,256,38.4
1037,2023-05-01,2023-05-31,5413,5864,451,67.65
1037,2023-06-01,2023-07-01,5864,6011,147,22.05
1037,2023-07-01,2023-07-31,6011,6406,395,59.25
1037,2023-08-01,2023-08-31,6406,6600,194,29.1
1037,2023-09-01,2023-10-01,6600,6845,245,36.75
1037,2023-10-01,2023-10-31,6845,7144,299,44.85
1037,2023-11-01,2023-12-01,7144,7320,176,26.4
1037,2023-12-01,2023-12-31,7320,7816,496,74.4
1038,2023-01-01,2023-01-31,4275,4385,110,16.5
1038,2023-02-01,2023-03-03,4385,4845,460,69.0
1038,2023-03-01,2023-03-31,4845,5239,394,59.1
1038,2023-04-01,2023-05-01,5239,5658,419,62.85
1038,2023-05-01,2023-05-31,5658,5835,177,26.55
1038,2023-06-01,2023-07-01,5835,6012,177,26.55
1038,2023-07-01,2023-07-31,6012,6264,252,37.8
1038,2023-08-01,2023-08-31,6264,6439,175,26.25
1038,2023-09-01,2023-10-01,6439,6791,352,52.8
1038,2023-10-01,2023-10-31,6791,7007,216,32.4
1038,2023-11-01,2023-12-01,7007,7438,431,64.65
1038,2023-12-01,2023-12-31,7438,7686,248,37.2
1039,2023-01-01,2023-01-31,2434,2544,110,16.5
1039,2023-02-01,2023-03-03,2544,2708,164,24.6
1039,2023-03-01,2023-03-31,2708,3015,307,46.05
1039,2023-04-01,2023-05-01,3015,3090,75,11.25
1039,2023-05-01,2023-05-31,3090,3261,171,25.65
1039,2023-06-01,2023-07-01,3261,3454,193,28.95
1039,2023-07-01,2023-07-31,3454,3882,428,64.2
1039,2023-08-01,2023-08-31,3882,4214,332,49.8
1039,2023-09-01,2023-10-01,4214,4382,168,25.2
1039,2023-10-01,2023-10-31,4382,4674,292,43.8
1039,2023-11-01,2023-12-01,4674,5060,386,57.9
1039,2023-12-01,2023-12-31,5060,5139,79,11.85
1040,2023-01-01,2023-01-31,1014,1486,472,70.8
1040,2023-02-01,2023-03-03,1486,1612,126,18.9
1040,2023-03-01,2023-03-31,1612,1947,335,50.25
1040,2023-04-01,2023-05-01,1947,2202,255,38.25
1040,2023-05-01,2023-05-31,2202,2679,477,71.55
1040,2023-06-01,2023-07-01,2679,2805,126,18.9
1040,2023-07-01,2023-07-31,2805,3221,416,62.4
1040,2023-08-01,2023-08-31,3221,3364,143,21.45
1040,2023-09-01,2023-10-01,3364,3643,279,41.85
1040,2023-10-01,2023-10-31,3643,3899,256,38.4
1040,2023-11-01,2023-12-01,3899,4064,165,24.75
1040,2023-12-01,2023-12-31,4064,4173,109,16.35
1041,2023-01-01,2023-01-31,4128,4614,486,72.9
1041,2023-02-01,2023-03-03,4614,4968,354,53.1
1041,2023-03-01,2023-03-31,4968,5057,89,13.35
1041,2023-04-01,2023-05-01,5057,5368,311,46.65
1041,2023-05-01,2023-05-31,5368,5648,280,42.0
1041,2023-06-01,2023-07-01,5648,6104,456,68.4
1041,2023-07-01,2023-07-31,6104,6393,289,43.35
1041,2023-08-01,2023-08-31,6393,6757,364,54.6
1041,2023-09-01,2023-10-01,6757,6877,120,18.0
1041,2023-10-01,2023-10-31,6877,7174,297,44.55
1041,2023-11-01,2023-12-01,7174,7305,131,19.65
1041,2023-12-01,2023-12-31,7305,7473,168,25.2
1042,2023-01-01,2023-01-31,1873,2176,303,45.45
1042,2023-02-01,2023-03-03,2176,2657,481,72.15
1042,2023-03-01,2023-03-31,2657,2804,147,22.05
1042,2023-04-01,2023-05-01,2804,3189,385,57.75
1042,2023-05-01,2023-05-31,3189,3294,105,15.75
1042,2023-06-01,2023-07-01,3294,3716,422,63.3
1042,2023-07-01,2023-07-31,3716,4077,361,54.15
1042,2023-08-01,2023-08-31,4077,4210,133,19.95
1042,2023-09-01,2023-10-01,4210,4330,120,18.0
1042,2023-10-01,2023-10-31,4330,4738,408,61.2
1042,2023-11-01,2023-12-01,4738,5117,379,56.85
1042,2023-12-01,2023-12-31,5117,5383,266,39.9
1043,2023-01-01,2023-01-31,3836,4328,492,73.8
1043,2023-02-01,2023-03-03,4328,4564,236,35.4
1043,2023-03-01,2023-03-31,4564,4940,376,56.4
1043,2023-04-01,2023-05-01,4940,5254,314,47.1
1043,2023-05-01,2023-05-31,5254,5349,95,14.25
1043,2023-06-01,2023-07-01,5349,5741,392,58.8
1043,2023-07-01,2023-07-31,5741,6163,422,63.3
1043,2023-08-01,2023-08-31,6163,6226,63,9.45
1043,2023-09-01,2023-10-01,6226,6573,347,52.05
1043,2023-10-01,2023-10-31,6573,6642,69,10.35
1043,2023-11-01,2023-12-01,6642,6836,194,29.1
1043,2023-12-01,2023-12-31,6836,7161,325,48.75
1044,2023-01-01,2023-01-31,2366,2673,307,46.05
1044,2023-02-01,2023-03-03,2673,3128,455,68.25
1044,2023-03-01,2023-03-31,3128,3560,432,64.8
1044,2023-04-01,2023-05-01,3560,3679,119,17.85
1044,2023-05-01,2023-05-31,3679,3907,228,34.2
1044,2023-06-01,2023-07-01,3907,4229,322,48.3
1044,2023-07-01,2023-07-31,4229,4402,173,25.95
1044,2023-08-01,2023-08-31,4402,4534,132,19.8
1044,2023-09-01,2023-10-01,4534,4735,201,30.15
1044,2023-10-01,2023-10-31,4735,4974,239,35.85
1044,2023-11-01,2023-12-01,4974,5180,206,30.9
1044,2023-12-01,2023-12-31,5180,5484,304,45.6
1045,2023-01-01,2023-01-31,1679,2128,449,67.35
1045,2023-02-01,2023-03-03,2128,2421,293,43.95
1045,2023-03-01,2023-03-31,2421,2520,99,14.85
1045,2023-04-01,2023-05-01,2520,2623,103,15.45
1045,2023-05-01,2023-05-31,2623,2804,181,27.15
1045,2023-06-01,2023-07-01,2804,3197,393,58.95
1045,2023-07-01,2023-07-31,3197,3679,482,72.3
1045,2023-08-01,2023-08-31,3679,3896,217,32.55
1045,2023-09-01,2023-10-01,3896,4332,436,65.4
1045,2023-10-01,2023-10-31,4332,4500,168,25.2
1045,2023-11-01,2023-12-01,4500,4576,76,11.4
1045,2023-12-01,2023-12-31,4576,4842,266,39.9
1046,2023-01-01,2023-01-31,2986,3106,120,18.0
1046,2023-02-01,2023-03-03,3106,3208,102,15.3
1046,2023-03-01,2023-03-31,3208,3608,400,60.0
1046,2023-04-01,2023-05-01,3608,3870,262,39.3
1046,2023-05-01,2023-05-31,3870,4126,256,38.4
1046,2023-06-01,2023-07-01,4126,4492,366,54.9
1046,2023-07-01,2023-07-31,4492,4788,296,44.4
1046,2023-08-01,2023-08-31,4788,4855,67,10.05
1046,2023-09-01,2023-10-01,4855,4978,123,18.45
1046,2023-10-01,2023-10-31,4978,5409,431,64.65
1046,2023-11-01,2023-12-01,5409,5774,365,54.75
1046,2023-12-01,2023-12-31,5774,6152,378,56.7
1047,2023-01-01,2023-01-31,1122,1478,356,53.4
1047,2023-02-01,2023-03-03,1478,1866,388,58.2
1047,2023-03-01,2023-03-31,1866,1948,82,12.3
1047,2023-04-01,2023-05-01,1948,2221,273,40.95
1047,2023-05-01,2023-05-31,2221,2556,335,50.25
1047,2023-06-01,2023-07-01,2556,2706,150,22.5
1047,2023-07-01,2023-07-31,2706,2929,223,33.45
1047,2023-08-01,2023-08-31,2929,3050,121,18.15
1047,2023-09-01,2023-10-01,3050,3343,293,43.95
1047,2023-10-01,2023-10-31,3343,3649,306,45.9
1047,2023-11-01,2023-12-01,3649,3717,68,10.2
1047,2023-12-01,2023-12-31,3717,4018,301,45.15
1048,2023-01-01,2023-01-31,1546,1671,125,18.75
1048,2023-02-01,2023-03-03,1671,1760,89,13.35
1048,2023-03-01,2023-03-31,1760,1954,194,29.1
1048,2023-04-01,2023-05-01,1954,2089,135,20.25
1048,2023-05-01,2023-05-31,2089,2501,412,61.8
1048,2023-06-01,2023-07-01,2501,2876,375,56.25
1048,2023-07-01,2023-07-31,2876,3245,369,55.35
1048,2023-08-01,2023-08-31,3245,3443,198,29.7
1048,2023-09-01,2023-10-01,3443,3790,347,52.05
1048,2023-10-01,2023-10-31,3790,4214,424,63.6
1048,2023-11-01,2023-12-01,4214,4266,52,7.8
1048,2023-12-01,2023-12-31,4266,4668,402,60.3
1049,2023-01-01,2023-01-31,1236,1380,144,21.6
1049,2023-02-01,2023-03-03,1380,1803,423,63.45
1049,2023-03-01,2023-03-31,1803,2204,401,60.15
1049,2023-04-01,2023-05-01,2204,2614,410,61.5
1049,2023-05-01,2023-05-31,2614,2902,288,43.2
1049,2023-06-01,2023-07-01,2902,3184,282,42.3
1049,2023-07-01,2023-07-31,3184,3281,97,14.55
1049,2023-08-01,2023-08-31,3281,3493,212,31.8
1049,2023-09-01,2023-10-01,3493,3921,428,64.2
1049,2023-10-01,2023-10-31,3921,4279,358,53.7
1049,2023-11-01,2023-12-01,4279,4638,359,53.85
1049,2023-12-01,2023-12-31,4638,4793,155,23.25
1050,2023-01-01,2023-01-31,2956,3387,431,64.65
1050,2023-02-01,2023-03-03,3387,3744,357,53.55
1050,2023-03-01,2023-03-31,3744,3824,80,12.0
1050,2023-04-01,2023-05-01,3824,4095,271,40.65
1050,2023-05-01,2023-05-31,4095,4371,276,41.4
1050,2023-06-01,2023-07-01,4371,4522,151,22.65
1050,2023-07-01,2023-07-31,4522,4674,152,22.8
1050,2023-08-01,2023-08-31,4674,5137,463,69.45
1050,2023-09-01,2023-10-01,5137,5210,73,10.95
1050,2023-10-01,2023-10-31,5210,5547,337,50.55
1050,2023-11-01,2023-12-01,5547,5805,258,38.7
1050,2023-12-01,2023-12-31,5805,6256,451,67.65
1051,2023-01-01,2023-01-31,4376,4863,487,73.05
1051,2023-02-01,2023-03-03,4863,4950,87,13.05
1051,2023-03-01,2023-03-31,4950,5148,198,29.7
1051,2023-04-01,2023-05-01,5148,5374,226,33.9
1051,2023-05-01,2023-05-31,5374,5655,281,42.15
1051,2023-06-01,2023-07-01,5655,6149,494,74.1
1051,2023-07-01,2023-07-31,6149,6277,128,19.2
1051,2023-08-01,2023-08-31,6277,6623,346,51.9
1051,2023-09-01,2023-10-01,6623,7027,404,60.6
1051,2023-10-01,2023-10-31,7027,7413,386,57.9
1051,2023-11-01,2023-12-01,7413,7674,261,39.15
1051,2023-12-01,2023-12-31,7674,7868,194,29.1
1052,2023-01-01,2023-01-31,3317,3480,163,24.45
1052,2023-02-01,2023-03-03,3480,3665,185,27.75
1052,2023-03-01,2023-03-31,3665,3901,236,35.4
1052,2023-04-01,2023-05-01,3901,4385,484,72.6
1052,2023-05-01,2023-05-31,4385,4720,335,50.25
1052,2023-06-01,2023-07-01,4720,5213,493,73.95
1052,2023-07-01,2023-07-31,5213,5528,315,47.25
1052,2023-08-01,2023-08-31,5528,5875,347,52.05
1052,2023-09-01,2023-10-01,5875,6181,306,45.9
1052,2023-10-01,2023-10-31,6181,6472,291,43.65
1052,2023-11-01,2023-12-01,6472,6840,368,55.2
1052,2023-12-01,2023-12-31,6840,6989,149,22.35
1053,2023-01-01,2023-01-31,4080,4479,399,59.85
1053,2023-02-01,2023-03-03,4479,4925,446,66.9
1053,2023-03-01,2023-03-31,4925,5194,269,40.35
1053,2023-04-01,2023-05-01,5194,5404,210,31.5
1053,2023-05-01,2023-05-31,5404,5743,339,50.85
1053,2023-06-01,2023-07-01,5743,6198,455,68.25
1053,2023-07-01,2023-07-31,6198,6679,481,72.15
1053,2023-08-01,2023-08-31,6679,7100,421,63.15
1053,2023-09-01,2023-10-01,7100,7563,463,69.45
1053,2023-10-01,2023-10-31,7563,7742,179,26.85
1053,2023-11-01,2023-12-01,7742,8154,412,61.8
1053,2023-12-01,2023-12-31,8154,8424,270,40.5
1054,2023-01-01,2023-01-31,3200,3644,444,66.6
1054,2023-02-01,2023-03-03,3644,4081,437,65.55
1054,2023-03-01,2023-03-31,4081,4441,360,54.0
1054,2023-04-01,2023-05-01,4441,4806,365,54.75
1054,2023-05-01,2023-05-31,4806,5289,483,72.45
1054,2023-06-01,2023-07-01,5289,5788,499,74.85
1054,2023-07-01,2023-07-31,5788,5948,160,24.0
1054,2023-08-01,2023-08-31,5948,6111,163,24.45
1054,2023-09-01,2023-10-01,6111,6204,93,13.95
1054,2023-10-01,2023-10-31,6204,6637,433,64.95
1054,2023-11-01,2023-12-01,6637,6691,54,8.1
1054,2023-12-01,2023-12-31,6691,7118,427,64.05
1055,2023-01-01,2023-01-31,1473,1821,348,52.2
1055,2023-02-01,2023-03-03,1821,2194,373,55.95
1055,2023-03-01,2023-03-31,2194,2684,490,73.5
1055,2023-04-01,2023-05-01,2684,2831,147,22.05
1055,2023-05-01,2023-05-31,2831,3042,211,31.65
1055,2023-06-01,2023-07-01,3042,3492,450,67.5
1055,2023-07-01,2023-07-31,3492,3726,234,35.1
1055,2023-08-01,2023-08-31,3726,4124,398,59.7
1055,2023-09-01,2023-10-01,4124,4249,125,18.75
1055,2023-10-01,2023-10-31,4249,4320,71,10.65
1055,2023-11-01,2023-12-01,4320,4727,407,61.05
1055,2023-12-01,2023-12-31,4727,5111,384,57.6
1056,2023-01-01,2023-01-31,1474,1751,277,41.55
1056,2023-02-01,2023-03-03,1751,2121,370,55.5
1056,2023-03-01,2023-03-31,2121,2592,471,70.65
1056,2023-04-01,2023-05-01,2592,2966,374,56.1
1056,2023-05-01,2023-05-31,2966,3256,290,43.5
1056,2023-06-01,2023-07-01,3256,3458,202,30.3
1056,2023-07-01,2023-07-31,3458,3568,110,16.5
1056,2023-08-01,2023-08-31,3568,4050,482,72.3
1056,2023-09-01,2023-10-01,4050,4285,235,35.25
1056,2023-10-01,2023-10-31,4285,4381,96,14.4
1056,2023-11-01,2023-12-01,4381,4605,224,33.6
1056,2023-12-01,2023-12-31,4605,5004,399,59.85
1057,2023-01-01,2023-01-31,4470,4904,434,65.1
1057,2023-02-01,2023-03-03,4904,4982,78,11.7
1057,2023-03-01,2023-03-31,4982,5330,348,52.2
1057,2023-04-01,2023-05-01,5330,5760,430,64.5
1057,2023-05-01,2023-05-31,5760,6233,473,70.95
1057,2023-06-01,2023-07-01,6233,6295,62,9.3
1057,2023-07-01,2023-07-31,6295,6764,469,70.35
1057,2023-08-01,2023-08-31,6764,6969,205,30.75
1057,2023-09-01,2023-10-01,6969,7173,204,30.6
1057,2023-10-01,2023-10-31,7173,7501,328,49.2
1057,2023-11-01,2023-12-01,7501,7768,267,40.05
1057,2023-12-01,2023-12-31,7768,7964,196,29.4
1058,2023-01-01,2023-01-31,2122,2396,274,41.1
1058,2023-02-01,2023-03-03,2396,2808,412,61.8
1058,2023-03-01,2023-03-31,2808,3116,308,46.2
1058,2023-04-01,2023-05-01,3116,3589,473,70.95
1058,2023-05-01,2023-05-31,3589,3643,54,8.1
1058,2023-06-01,2023-07-01,3643,4050,407,61.05
1058,2023-07-01,2023-07-31,4050,4521,471,70.65
1058,2023-08-01,2023-08-31,4521,4790,269,40.35
1058,2023-09-01,2023-10-01,4790,4881,91,13.65
1058,2023-10-01,2023-10-31,4881,5135,254,38.1
1058,2023-11-01,2023-12-01,5135,5301,166,24.9
1058,2023-12-01,2023-12-31,5301,5407,106,15.9
1059,2023-01-01,2023-01-31,4306,4406,100,15.0
1059,2023-02-01,2023-03-03,4406,4611,205,30.75
1059,2023-03-01,2023-03-31,4611,5033,422,63.3
1059,2023-04-01,2023-05-01,5033,5154,121,18.15
1059,2023-05-01,2023-05-31,5154,5547,393,58.95
1059,2023-06-01,2023-07-01,5547,5858,311,46.65
1059,2023-07-01,2023-07-31,5858,5995,137,20.55
1059,2023-08-01,2023-08-31,5995,6248,253,37.95
1059,2023-09-01,2023-10-01,6248,6586,338,50.7
1059,2023-10-01,2023-10-31,6586,6942,356,53.4
1059,2023-11-01,2023-12-01,6942,7189,247,37.05
1059,2023-12-01,2023-12-31,7189,7322,133,19.95
1060,2023-01-01,2023-01-31,3548,3783,235,35.25
1060,2023-02-01,2023-03-03,3783,4039,256,38.4
1060,2023-03-01,2023-03-31,4039,4177,138,20.7
1060,2023-04-01,2023-05-01,4177,4255,78,11.7
1060,2023-05-01,2023-05-31,4255,4417,162,24.3
1060,2023-06-01,2023-07-01,4417,4668,251,37.65
1060,2023-07-01,2023-07-31,4668,4815,147,22.05
1060,2023-08-01,2023-08-31,4815,4921,106,15.9
1060,2023-09-01,2023-10-01,4921,5178,257,38.55
1060,2023-10-01,2023-10-31,5178,5320,142,21.3
1060,2023-11-01,2023-12-01,5320,5648,328,49.2
1060,2023-12-01,2023-12-31,5648,6011,363,54.45
1061,2023-01-01,2023-01-31,2314,2701,387,58.05
1061,2023-02-01,2023-03-03,2701,3018,317,47.55
1061,2023-03-01,2023-03-31,3018,3265,247,37.05
1061,2023-04-01,2023-05-01,3265,3477,212,31.8
1061,2023-05-01,2023-05-31,3477,3736,259,38.85
1061,2023-06-01,2023-07-01,3736,3820,84,12.6
1061,2023-07-01,2023-07-31,3820,4214,394,59.1
1061,2023-08-01,2023-08-31,4214,4667,453,67.95
1061,2023-09-01,2023-10-01,4667,4998,331,49.65
1061,2023-10-01,2023-10-31,4998,5477,479,71.85
1061,2023-11-01,2023-12-01,5477,5548,71,10.65
1061,2023-12-01,2023-12-31,5548,6047,499,74.85
1062,2023-01-01,2023-01-31,3478,3696,218,32.7
1062,2023-02-01,2023-03-03,3696,3931,235,35.25
1062,2023-03-01,2023-03-31,3931,4056,125,18.75
1062,2023-04-01,2023-05-01,4056,4497,441,66.15
1062,2023-05-01,2023-05-31,4497,4949,452,67.8
1062,2023-06-01,2023-07-01,4949,5140,191,28.65
1062,2023-07-01,2023-07-31,5140,5296,156,23.4
1062,2023-08-01,2023-08-31,5296,5605,309,46.35
1062,2023-09-01,2023-10-01,5605,5765,160,24.0
1062,2023-10-01,2023-10-31,5765,6099,334,50.1
1062,2023-11-01,2023-12-01,6099,6383,284,42.6
1062,2023-12-01,2023-12-31,6383,6827,444,66.6
1063,2023-01-01,2023-01-31,4559,4731,172,25.8
1063,2023-02-01,2023-03-03,4731,4965,234,35.1
1063,2023-03-01,2023-03-31,4965,5440,475,71.25
1063,2023-04-01,2023-05-01,5440,5676,236,35.4
1063,2023-05-01,2023-05-31,5676,6101,425,63.75
1063,2023-06-01,2023-07-01,6101,6272,171,25.65
1063,2023-07-01,2023-07-31,6272,6695,423,63.45
1063,2023-08-01,2023-08-31,6695,7098,403,60.45
1063,2023-09-01,2023-10-01,7098,7375,277,41.55
1063,2023-10-01,2023-10-31,7375,7666,291,43.65
1063,2023-11-01,2023-12-01,7666,7800,134,20.1
1063,2023-12-01,2023-12-31,7800,8072,272,40.8
1064,2023-01-01,2023-01-31,4475,4867,392,58.8
1064,2023-02-01,2023-03-03,4867,4957,90,13.5
1064,2023-03-01,2023-03-31,4957,5321,364,54.6
1064,2023-04-01,2023-05-01,5321,5543,222,33.3
1064,2023-05-01,2023-05-31,5543,5639,96,14.4
1064,2023-06-01,2023-07-01,5639,5862,223,33.45
1064,2023-07-01,2023-07-31,5862,6029,167,25.05
1064,2023-08-01,2023-08-31,6029,6489,460,69.0
1064,2023-09-01,2023-10-01,6489,6691,202,30.3
1064,2023-10-01,2023-10-31,6691,6848,157,23.55
1064,2023-11-01,2023-12-01,6848,7152,304,45.6
1064,2023-12-01,2023-12-31,7152,7245,93,13.95
1065,2023-01-01,2023-01-31,2878,3325,447,67.05
1065,2023-02-01,2023-03-03,3325,3712,387,58.05
1065,2023-03-01,2023-03-31,3712,3937,225,33.75
1065,2023-04-01,2023-05-01,3937,4361,424,63.6
1065,2023-05-01,2023-05-31,4361,4740,379,56.85
1065,2023-06-01,2023-07-01,4740,4915,175,26.25
1065,2023-07-01,2023-07-31,4915,5240,325,48.75
1065,2023-08-01,2023-08-31,5240,5662,422,63.3
1065,2023-09-01,2023-10-01,5662,5985,323,48.45
1065,2023-10-01,2023-10-31,5985,6243,258,38.7
1065,2023-11-01,2023-12-01,6243,6319,76,11.4
1065,2023-12-01,2023-12-31,6319,6532,213,31.95
1066,2023-01-01,2023-01-31,3491,3766,275,41.25
1066,2023-02-01,2023-03-03,3766,4000,234,35.1
1066,2023-03-01,2023-03-31,4000,4406,406,60.9
1066,2023-04-01,2023-05-01,4406,4647,241,36.15
1066,2023-05-01,2023-05-31,4647,4979,332,49.8
1066,2023-06-01,2023-07-01,4979,5478,499,74.85
1066,2023-07-01,2023-07-31,5478,5846,368,55.2
1066,2023-08-01,2023-08-31,5846,6325,479,71.85
1066,2023-09-01,2023-10-01,6325,6636,311,46.65
1066,2023-10-01,2023-10-31,6636,6802,166,24.9
1066,2023-11-01,2023-12-01,6802,7285,483,72.45
1066,2023-12-01,2023-12-31,7285,7373,88,13.2
1067,2023-01-01,2023-01-31,2373,2464,91,13.65
1067,2023-02-01,2023-03-03,2464,2952,488,73.2
1067,2023-03-01,2023-03-31,2952,3329,377,56.55
1067,2023-04-01,2023-05-01,3329,3725,396,59.4
1067,2023-05-01,2023-05-31,3725,4126,401,60.15
1067,2023-06-01,2023-07-01,4126,4282,156,23.4
1067,2023-07-01,2023-07-31,4282,4721,439,65.85
1067,2023-08-01,2023-08-31,4721,5078,357,53.55
1067,2023-09-01,2023-10-01,5078,5228,150,22.5
1067,2023-10-01,2023-10-31,5228,5384,156,23.4
1067,2023-11-01,2023-12-01,5384,5794,410,61.5
1067,2023-12-01,2023-12-31,5794,6024,230,34.5
1068,2023-01-01,2023-01-31,4468,4709,241,36.15
1068,2023-02-01,2023-03-03,4709,4917,208,31.2
1068,2023-03-01,2023-03-31,4917,5108,191,28.65
1068,2023-04-01,2023-05-01,5108,5427,319,47.85
1068,2023-05-01,2023-05-31,5427,5511,84,12.6
1068,2023-06-01,2023-07-01,5511,5681,170,25.5
1068,2023-07-01,2023-07-31,5681,6095,414,62.1
1068,2023-08-01,2023-08-31,6095,6522,427,64.05
1068,2023-09-01,2023-10-01,6522,6951,429,64.35
1068,2023-10-01,2023-10-31,6951,7019,68,10.2
1068,2023-11-01,2023-12-01,7019,7508,489,73.35
1068,2023-12-01,2023-12-31,7508,7912,404,60.6
1069,2023-01-01,2023-01-31,4861,5228,367,55.05
1069,2023-02-01,2023-03-03,5228,5702,474,71.1
1069,2023-03-01,2023-03-31,5702,5759,57,8.55
1069,2023-04-01,2023-05-01,5759,6031,272,40.8
1069,2023-05-01,2023-05-31,6031,6395,364,54.6
1069,2023-06-01,2023-07-01,6395,6685,290,43.5
1069,2023-07-01,2023-07-31,6685,7178,493,73.95
1069,2023-08-01,2023-08-31,7178,7566,388,58.2
1069,2023-09-01,2023-10-01,7566,7893,327,49.05
1069,2023-10-01,2023-10-31,7893,8392,499,74.85
1069,2023-11-01,2023-12-01,8392,8627,235,35.25
1069,2023-12-01,2023-12-31,8627,9112,485,72.75
1070,2023-01-01,2023-01-31,2566,2796,230,34.5
1070,2023-02-01,2023-03-03,2796,2962,166,24.9
1070,2023-03-01,2023-03-31,2962,3129,167,25.05
1070,2023-04-01,2023-05-01,3129,3320,191,28.65
1070,2023-05-01,2023-05-31,3320,3479,159,23.85
1070,2023-06-01,2023-07-01,3479,3879,400,60.0
1070,2023-07-01,2023-07-31,3879,4164,285,42.75
1070,2023-08-01,2023-08-31,4164,4524,360,54.0
1070,2023-09-01,2023-10-01,4524,4625,101,15.15
1070,2023-10-01,2023-10-31,4625,4912,287,43.05
1070,2023-11-01,2023-12-01,4912,5073,161,24.15
1070,2023-12-01,2023-12-31,5073,5222,149,22.35
1071,2023-01-01,2023-01-31,3748,3931,183,27.45
1071,2023-02-01,2023-03-03,3931,4251,320,48.0
1071,2023-03-01,2023-03-31,4251,4533,282,42.3
1071,2023-04-01,2023-05-01,4533,4942,409,61.35
1071,2023-05-01,2023-05-31,4942,5003,61,9.15
1071,2023-06-01,2023-07-01,5003,5297,294,44.1
1071,2023-07-01,2023-07-31,5297,5755,458,68.7
1071,2023-08-01,2023-08-31,5755,6077,322,48.3
1071,2023-09-01,2023-10-01,6077,6293,216,32.4
1071,2023-10-01,2023-10-31,6293,6662,369,55.35
1071,2023-11-01,2023-12-01,6662,6924,262,39.3
1071,2023-12-01,2023-12-31,6924,7105,181,27.15
1072,2023-01-01,2023-01-31,3869,4114,245,36.75
1072,2023-02-01,2023-03-03,4114,4601,487,73.05
1072,2023-03-01,2023-03-31,4601,4807,206,30.9
1072,2023-04-01,2023-05-01,4807,5285,478,71.7
1072,2023-05-01,2023-05-31,5285,5342,57,8.55
1072,2023-06-01,2023-07-01,5342,5652,310,46.5
1072,2023-07-01,2023-07-31,5652,6006,354,53.1
1072,2023-08-01,2023-08-31,6006,6285,279,41.85
1072,2023-09-01,2023-10-01,6285,6523,238,35.7
1072,2023-10-01,2023-10-31,6523,6639,116,17.4
1072,2023-11-01,2023-12-01,6639,6812,173,25.95
1072,2023-12-01,2023-12-31,6812,6966,154,23.1
1073,2023-01-01,2023-01-31,1521,1877,356,53.4
1073,2023-02-01,2023-03-03,1877,2321,444,66.6
1073,2023-03-01,2023-03-31,2321,2582,261,39.15
1073,2023-04-01,2023-05-01,2582,2750,168,25.2
1073,2023-05-01,2023-05-31,2750,2895,145,21.75
1073,2023-06-01,2023-07-01,2895,3360,465,69.75
1073,2023-07-01,2023-07-31,3360,3549,189,28.35
1073,2023-08-01,2023-08-31,3549,3671,122,18.3
1073,2023-09-01,2023-10-01,3671,3813,142,21.3
1073,2023-10-01,2023-10-31,3813,3878,65,9.75
1073,2023-11-01,2023-12-01,3878,4136,258,38.7
1073,2023-12-01,2023-12-31,4136,4199,63,9.45
1074,2023-01-01,2023-01-31,1913,2078,165,24.75
1074,2023-02-01,2023-03-03,2078,2236,158,23.7
1074,2023-03-01,2023-03-31,2236,2605,369,55.35
1074,2023-04-01,2023-05-01,2605,2968,363,54.45
1074,2023-05-01,2023-05-31,2968,3422,454,68.1
1074,2023-06-01,2023-07-01,3422,3507,85,12.75
1074,2023-07-01,2023-07-31,3507,3797,290,43.5
1074,2023-08-01,2023-08-31,3797,4014,217,32.55
1074,2023-09-01,2023-10-01,4014,4375,361,54.15
1074,2023-10-01,2023-10-31,4375,4612,237,35.55
1074,2023-11-01,2023-12-01,4612,4752,140,21.0
1074,2023-12-01,2023-12-31,4752,4936,184,27.6
1075,2023-01-01,2023-01-31,3275,3732,457,68.55
1075,2023-02-01,2023-03-03,3732,4160,428,64.2
1075,2023-03-01,2023-03-31,4160,4606,446,66.9
1075,2023-04-01,2023-05-01,4606,5055,449,67.35
1075,2023-05-01,2023-05-31,5055,5225,170,25.5
1075,2023-06-01,2023-07-01,5225,5676,451,67.65
1075,2023-07-01,2023-07-31,5676,5810,134,20.1
1075,2023-08-01,2023-08-31,5810,5893,83,12.45
1075,2023-09-01,2023-10-01,5893,5943,50,7.5
1075,2023-10-01,2023-10-31,5943,6358,415,62.25
1075,2023-11-01,2023-12-01,6358,6502,144,21.6
1075,2023-12-01,2023-12-31,6502,6588,86,12.9
1076,2023-01-01,2023-01-31,1547,1763,216,32.4
1076,2023-02-01,2023-03-03,1763,1953,190,28.5
1076,2023-03-01,2023-03-31,1953,2096,143,21.45
1076,2023-04-01,2023-05-01,2096,2397,301,45.15
1076,2023-05-01,2023-05-31,2397,2766,369,55.35
1076,2023-06-01,2023-07-01,2766,3021,255,38.25
1076,2023-07-01,2023-07-31,3021,3354,333,49.95
1076,2023-08-01,2023-08-31,3354,3801,447,67.05
1076,2023-09-01,2023-10-01,3801,4092,291,43.65
1076,2023-10-01,2023-10-31,4092,4538,446,66.9
1076,2023-11-01,2023-12-01,4538,4979,441,66.15
1076,2023-12-01,2023-12-31,4979,5092,113,16.95
1077,2023-01-01,2023-01-31,4057,4555,498,74.7
1077,2023-02-01,2023-03-03,4555,4964,409,61.35
1077,2023-03-01,2023-03-31,4964,5304,340,51.0
1077,2023-04-01,2023-05-01,5304,5743,439,65.85
1077,2023-05-01,2023-05-31,5743,6187,444,66.6
1077,2023-06-01,2023-07-01,6187,6286,99,14.85
1077,2023-07-01,2023-07-31,6286,6699,413,61.95
1077,2023-08-01,2023-08-31,6699,6835,136,20.4
1077,2023-09-01,2023-10-01,6835,7306,471,70.65
1077,2023-10-01,2023-10-31,7306,7587,281,42.15
1077,2023-11-01,2023-12-01,7587,8056,469,70.35
1077,2023-12-01,2023-12-31,8056,8422,366,54.9
1078,2023-01-01,2023-01-31,1083,1432,349,52.35
1078,2023-02-01,2023-03-03,1432,1822,390,58.5
1078,2023-03-01,2023-03-31,1822,2173,351,52.65
1078,2023-04-01,2023-05-01,2173,2365,192,28.8
1078,2023-05-01,2023-05-31,2365,2725,360,54.0
1078,2023-06-01,2023-07-01,2725,3111,386,57.9
1078,2023-07-01,2023-07-31,3111,3581,470,70.5
1078,2023-08-01,2023-08-31,3581,3894,313,46.95
1078,2023-09-01,2023-10-01,3894,4291,397,59.55
1078,2023-10-01,2023-10-31,4291,4658,367,55.05
1078,2023-11-01,2023-12-01,4658,4981,323,48.45
1078,2023-12-01,2023-12-31,4981,5367,386,57.9
1079,2023-01-01,2023-01-31,3513,3839,326,48.9
1079,2023-02-01,2023-03-03,3839,3896,57,8.55
1079,2023-03-01,2023-03-31,3896,4078,182,27.3
1079,2023-04-01,2023-05-01,4078,4391,313,46.95
1079,2023-05-01,2023-05-31,4391,4530,139,20.85
1079,2023-06-01,2023-07-01,4530,4979,449,67.35
1079,2023-07-01,2023-07-31,4979,5075,96,14.4
1079,2023-08-01,2023-08-31,5075,5471,396,59.4
1079,2023-09-01,2023-10-01,5471,5630,159,23.85
1079,2023-10-01,2023-10-31,5630,5931,301,45.15
1079,2023-11-01,2023-12-01,5931,6367,436,65.4
1079,2023-12-01,2023-12-31,6367,6670,303,45.45
1080,2023-01-01,2023-01-31,3221,3581,360,54.0
1080,2023-02-01,2023-03-03,3581,3844,263,39.45
1080,2023-03-01,2023-03-31,3844,3999,155,23.25
1080,2023-04-01,2023-05-01,3999,4205,206,30.9
1080,2023-05-01,2023-05-31,4205,4379,174,26.1
1080,2023-06-01,2023-07-01,4379,4630,251,37.65
1080,2023-07-01,2023-07-31,4630,5077,447,67.05
1080,2023-08-01,2023-08-31,5077,5555,478,71.7
1080,2023-09-01,2023-10-01,5555,5934,379,56.85
1080,2023-10-01,2023-10-31,5934,6232,298,44.7
1080,2023-11-01,2023-12-01,6232,6438,206,30.9
1080,2023-12-01,2023-12-31,6438,6937,499,74.85
1081,2023-01-01,2023-01-31,4298,4419,121,18.15
1081,2023-02-01,2023-03-03,4419,4631,212,31.8
1081,2023-03-01,2023-03-31,4631,5129,498,74.7
1081,2023-04-01,2023-05-01,5129,5305,176,26.4
1081,2023-05-01,2023-05-31,5305,5805,500,75.0
1081,2023-06-01,2023-07-01,5805,6097,292,43.8
1081,2023-07-01,2023-07-31,6097,6236,139,20.85
1081,2023-08-01,2023-08-31,6236,6457,221,33.15
1081,2023-09-01,2023-10-01,6457,6881,424,63.6
1081,2023-10-01,2023-10-31,6881,6933,52,7.8
1081,2023-11-01,2023-12-01,6933,7278,345,51.75
1081,2023-12-01,2023-12-31,7278,7404,126,18.9
1082,2023-01-01,2023-01-31,1753,2131,378,56.7
1082,2023-02-01,2023-03-03,2131,2622,491,73.65
1082,2023-03-01,2023-03-31,2622,2855,233,34.95
1082,2023-04-01,2023-05-01,2855,3277,422,63.3
1082,2023-05-01,2023-05-31,3277,3696,419,62.85
1082,2023-06-01,2023-07-01,3696,4080,384,57.6
1082,2023-07-01,2023-07-31,4080,4530,450,67.5
1082,2023-08-01,2023-08-31,4530,4754,224,33.6
1082,2023-09-01,2023-10-01,4754,5251,497,74.55
1082,2023-10-01,2023-10-31,5251,5517,266,39.9
1082,2023-11-01,2023-12-01,5517,5963,446,66.9
1082,2023-12-01,2023-12-31,5963,6186,223,33.45
1083,2023-01-01,2023-01-31,3771,4058,287,43.05
1083,2023-02-01,2023-03-03,4058,4428,370,55.5
1083,2023-03-01,2023-03-31,4428,4531,103,15.45
1083,2023-04-01,2023-05-01,4531,4713,182,27.3
1083,2023-05-01,2023-05-31,4713,5055,342,51.3
1083,2023-06-01,2023-07-01,5055,5112,57,8.55
1083,2023-07-01,2023-07-31,5112,5208,96,14.4
1083,2023-08-01,2023-08-31,5208,5617,409,61.35
1083,2023-09-01,2023-10-01,5617,5696,79,11.85
1083,2023-10-01,2023-10-31,5696,6190,494,74.1
1083,2023-11-01,2023-12-01,6190,6389,199,29.85
1083,2023-12-01,2023-12-31,6389,6670,281,42.15
1084,2023-01-01,2023-01-31,3929,4239,310,46.5
1084,2023-02-01,2023-03-03,4239,4317,78,11.7
1084,2023-03-01,2023-03-31,4317,4737,420,63.0
1084,2023-04-01,2023-05-01,4737,4797,60,9.0
1084,2023-05-01,2023-05-31,4797,5060,263,39.45
1084,2023-06-01,2023-07-01,5060,5122,62,9.3
1084,2023-07-01,2023-07-31,5122,5349,227,34.05
1084,2023-08-01,2023-08-31,5349,5558,209,31.35
1084,2023-09-01,2023-10-01,5558,5819,261,39.15
1084,2023-10-01,2023-10-31,5819,6242,423,63.45
1084,2023-11-01,2023-12-01,6242,6675,433,64.95
1084,2023-12-01,2023-12-31,6675,7152,477,71.55
1085,2023-01-01,2023-01-31,3721,3878,157,23.55
1085,2023-02-01,2023-03-03,3878,4353,475,71.25
1085,2023-03-01,2023-03-31,4353,4417,64,9.6
1085,2023-04-01,2023-05-01,4417,4715,298,44.7
1085,2023-05-01,2023-05-31,4715,4886,171,25.65
1085,2023-06-01,2023-07-01,4886,5380,494,74.1
1085,2023-07-01,2023-07-31,5380,5667,287,43.05
1085,2023-08-01,2023-08-31,5667,5838,171,25.65
1085,2023-09-01,2023-10-01,5838,6230,392,58.8
1085,2023-10-01,2023-10-31,6230,6300,70,10.5
1085,2023-11-01,2023-12-01,6300,6456,156,23.4
1085,2023-12-01,2023-12-31,6456,6952,496,74.4
1086,2023-01-01,2023-01-31,1781,2041,260,39.0
1086,2023-02-01,2023-03-03,2041,2276,235,35.25
1086,2023-03-01,2023-03-31,2276,2770,494,74.1
1086,2023-04-01,2023-05-01,2770,3017,247,37.05
1086,2023-05-01,2023-05-31,3017,3089,72,10.8
1086,2023-06-01,2023-07-01,3089,3371,282,42.3
1086,2023-07-01,2023-07-31,3371,3454,83,12.45
1086,2023-08-01,2023-08-31,3454,3653,199,29.85
1086,2023-09-01,2023-10-01,3653,3895,242,36.3
1086,2023-10-01,2023-10-31,3895,4165,270,40.5
1086,2023-11-01,2023-12-01,4165,4418,253,37.95
1086,2023-12-01,2023-12-31,4418,4799,381,57.15
1087,2023-01-01,2023-01-31,4304,4766,462,69.3
1087,2023-02-01,2023-03-03,4766,4862,96,14.4
1087,2023-03-01,2023-03-31,4862,5362,500,75.0
1087,2023-04-01,2023-05-01,5362,5793,431,64.65
1087,2023-05-01,2023-05-31,5793,6072,279,41.85
1087,2023-06-01,2023-07-01,6072,6138,66,9.9
1087,2023-07-01,2023-07-31,6138,6473,335,50.25
1087,2023-08-01,2023-08-31,6473,6795,322,48.3
1087,2023-09-01,2023-10-01,6795,7295,500,75.0
1087,2023-10-01,2023-10-31,7295,7580,285,42.75
1087,2023-11-01,2023-12-01,7580,7718,138,20.7
1087,2023-12-01,2023-12-31,7718,7786,68,10.2
1088,2023-01-01,2023-01-31,3332,3529,197,29.55
1088,2023-02-01,2023-03-03,3529,3887,358,53.7
1088,2023-03-01,2023-03-31,3887,4149,262,39.3
1088,2023-04-01,2023-05-01,4149,4244,95,14.25
1088,2023-05-01,2023-05-31,4244,4422,178,26.7
1088,2023-06-01,2023-07-01,4422,4771,349,52.35
1088,2023-07-01,2023-07-31,4771,5183,412,61.8
1088,2023-08-01,2023-08-31,5183,5591,408,61.2
1088,2023-09-01,2023-10-01,5591,5718,127,19.05
1088,2023-10-01,2023-10-31,5718,6059,341,51.15
1088,2023-11-01,2023-12-01,6059,6346,287,43.05
1088,2023-12-01,2023-12-31,6346,6711,365,54.75
1089,2023-01-01,2023-01-31,4150,4477,327,49.05
1089,2023-02-01,2023-03-03,4477,4781,304,45.6
1089,2023-03-01,2023-03-31,4781,5228,447,67.05
1089,2023-04-01,2023-05-01,5228,5495,267,40.05
1089,2023-05-01,2023-05-31,5495,5713,218,32.7
1089,2023-06-01,2023-07-01,5713,5940,227,34.05
1089,2023-07-01,2023-07-31,5940,6313,373,55.95
1089,2023-08-01,2023-08-31,6313,6536,223,33.45
1089,2023-09-01,2023-10-01,6536,6855,319,47.85
1089,2023-10-01,2023-10-31,6855,7071,216,32.4
1089,2023-11-01,2023-12-01,7071,7366,295,44.25
1089,2023-12-01,2023-12-31,7366,7621,255,38.25
1090,2023-01-01,2023-01-31,2372,2594,222,33.3
1090,2023-02-01,2023-03-03,2594,2817,223,33.45
1090,2023-03-01,2023-03-31,2817,2888,71,10.65
1090,2023-04-01,2023-05-01,2888,3266,378,56.7
1090,2023-05-01,2023-05-31,3266,3391,125,18.75
1090,2023-06-01,2023-07-01,3391,3837,446,66.9
1090,2023-07-01,2023-07-31,3837,4265,428,64.2
1090,2023-08-01,2023-08-31,4265,4459,194,29.1
1090,2023-09-01,2023-10-01,4459,4951,492,73.8
1090,2023-10-01,2023-10-31,4951,5081,130,19.5
1090,2023-11-01,2023-12-01,5081,5475,394,59.1
1090,2023-12-01,2023-12-31,5475,5716,241,36.15
1091,2023-01-01,2023-01-31,4353,4542,189,28.35
1091,2023-02-01,2023-03-03,4542,4795,253,37.95
1091,2023-03-01,2023-03-31,4795,5094,299,44.85
1091,2023-04-01,2023-05-01,5094,5509,415,62.25
1091,2023-05-01,2023-05-31,5509,5909,400,60.0
1091,2023-06-01,2023-07-01,5909,6384,475,71.25
1091,2023-07-01,2023-07-31,6384,6735,351,52.65
1091,2023-08-01,2023-08-31,6735,6840,105,15.75
1091,2023-09-01,2023-10-01,6840,7008,168,25.2
1091,2023-10-01,2023-10-31,7008,7135,127,19.05
1091,2023-11-01,2023-12-01,7135,7498,363,54.45
1091,2023-12-01,2023-12-31,7498,7794,296,44.4
1092,2023-01-01,2023-01-31,2972,3056,84,12.6
1092,2023-02-01,2023-03-03,3056,3115,59,8.85
1092,2023-03-01,2023-03-31,3115,3566,451,67.65
1092,2023-04-01,2023-05-01,3566,3657,91,13.65
1092,2023-05-01,2023-05-31,3657,3845,188,28.2
1092,2023-06-01,2023-07-01,3845,3895,50,7.5
1092,2023-07-01,2023-07-31,3895,4037,142,21.3
1092,2023-08-01,2023-08-31,4037,4418,381,57.15
1092,2023-09-01,2023-10-01,4418,4917,499,74.85
1092,2023-10-01,2023-10-31,4917,5347,430,64.5
1092,2023-11-01,2023-12-01,5347,5737,390,58.5
1092,2023-12-01,2023-12-31,5737,6237,500,75.0
1093,2023-01-01,2023-01-31,1580,1779,199,29.85
1093,2023-02-01,2023-03-03,1779,2279,500,75.0
1093,2023-03-01,2023-03-31,2279,2434,155,23.25
1093,2023-04-01,2023-05-01,2434,2619,185,27.75
1093,2023-05-01,2023-05-31,2619,2843,224,33.6
1093,2023-06-01,2023-07-01,2843,3167,324,48.6
1093,2023-07-01,2023-07-31,3167,3234,67,10.05
1093,2023-08-01,2023-08-31,3234,3721,487,73.05
1093,2023-09-01,2023-10-01,3721,3854,133,19.95
1093,2023-10-01,2023-10-31,3854,3905,51,7.65
1093,2023-11-01,2023-12-01,3905,4160,255,38.25
1093,2023-12-01,2023-12-31,4160,4491,331,49.65
1094,2023-01-01,2023-01-31,2460,2708,248,37.2
1094,2023-02-01,2023-03-03,2708,2865,157,23.55
1094,2023-03-01,2023-03-31,2865,3358,493,73.95
1094,2023-04-01,2023-05-01,3358,3573,215,32.25
1094,2023-05-01,2023-05-31,3573,3728,155,23.25
1094,2023-06-01,2023-07-01,3728,4146,418,62.7
1094,2023-07-01,2023-07-31,4146,4285,139,20.85
1094,2023-08-01,2023-08-31,4285,4708,423,63.45
1094,2023-09-01,2023-10-01,4708,4769,61,9.15
1094,2023-10-01,2023-10-31,4769,4823,54,8.1
1094,2023-11-01,2023-12-01,4823,5099,276,41.4
1094,2023-12-01,2023-12-31,5099,5537,438,65.7
1095,2023-01-01,2023-01-31,4701,5105,404,60.6
1095,2023-02-01,2023-03-03,5105,5420,315,47.25
1095,2023-03-01,2023-03-31,5420,5811,391,58.65
1095,2023-04-01,2023-05-01,5811,6260,449,67.35
1095,2023-05-01,2023-05-31,6260,6641,381,57.15
1095,2023-06-01,2023-07-01,6641,6961,320,48.0
1095,2023-07-01,2023-07-31,6961,7227,266,39.9
1095,2023-08-01,2023-08-31,7227,7547,320,48.0
1095,2023-09-01,2023-10-01,7547,7650,103,15.45
1095,2023-10-01,2023-10-31,7650,7849,199,29.85
1095,2023-11-01,2023-12-01,7849,8199,350,52.5
1095,2023-12-01,2023-12-31,8199,8550,351,52.65
1096,2023-01-01,2023-01-31,1785,1935,150,22.5
1096,2023-02-01,2023-03-03,1935,2005,70,10.5
1096,2023-03-01,2023-03-31,2005,2149,144,21.6
1096,2023-04-01,2023-05-01,2149,2239,90,13.5
1096,2023-05-01,2023-05-31,2239,2516,277,41.55
1096,2023-06-01,2023-07-01,2516,2712,196,29.4
1096,2023-07-01,2023-07-31,2712,3106,394,59.1
1096,2023-08-01,2023-08-31,3106,3418,312,46.8
1096,2023-09-01,2023-10-01,3418,3867,449,67.35
1096,2023-10-01,2023-10-31,3867,4029,162,24.3
1096,2023-11-01,2023-12-01,4029,4156,127,19.05
1096,2023-12-01,2023-12-31,4156,4576,420,63.0
1097,2023-01-01,2023-01-31,3546,4041,495,74.25
1097,2023-02-01,2023-03-03,4041,4447,406,60.9
1097,2023-03-01,2023-03-31,4447,4928,481,72.15
1097,2023-04-01,2023-05-01,4928,5101,173,25.95
1097,2023-05-01,2023-05-31,5101,5471,370,55.5
1097,2023-06-01,2023-07-01,5471,5879,408,61.2
1097,2023-07-01,2023-07-31,5879,6063,184,27.6
1097,2023-08-01,2023-08-31,6063,6525,462,69.3
1097,2023-09-01,2023-10-01,6525,6934,409,61.35
1097,2023-10-01,2023-10-31,6934,7323,389,58.35
1097,2023-11-01,2023-12-01,7323,7429,106,15.9
1097,2023-12-01,2023-12-31,7429,7495,66,9.9
1098,2023-01-01,2023-01-31,4055,4543,488,73.2
1098,2023-02-01,2023-03-03,4543,4658,115,17.25
1098,2023-03-01,2023-03-31,4658,5094,436,65.4
1098,2023-04-01,2023-05-01,5094,5279,185,27.75
1098,2023-05-01,2023-05-31,5279,5593,314,47.1
1098,2023-06-01,2023-07-01,5593,5760,167,25.05
1098,2023-07-01,2023-07-31,5760,6004,244,36.6
1098,2023-08-01,2023-08-31,6004,6157,153,22.95
1098,2023-09-01,2023-10-01,6157,6305,148,22.2
1098,2023-10-01,2023-10-31,6305,6755,450,67.5
1098,2023-11-01,2023-12-01,6755,7015,260,39.0
1098,2023-12-01,2023-12-31,7015,7491,476,71.4
1099,2023-01-01,2023-01-31,3186,3345,159,23.85
1099,2023-02-01,2023-03-03,3345,3793,448,67.2
1099,2023-03-01,2023-03-31,3793,4091,298,44.7
1099,2023-04-01,2023-05-01,4091,4289,198,29.7
1099,2023-05-01,2023-05-31,4289,4368,79,11.85
1099,2023-06-01,2023-07-01,4368,4783,415,62.25
1099,2023-07-01,2023-07-31,4783,5038,255,38.25
1099,2023-08-01,2023-08-31,5038,5374,336,50.4
1099,2023-09-01,2023-10-01,5374,5760,386,57.9
1099,2023-10-01,2023-10-31,5760,6071,311,46.65
1099,2023-11-01,2023-12-01,6071,6180,109,16.35
1099,2023-12-01,2023-12-31,6180,6338,158,23.7
1100,2023-01-01,2023-01-31,4743,5029,286,42.9
1100,2023-02-01,2023-03-03,5029,5142,113,16.95
1100,2023-03-01,2023-03-31,5142,5256,114,17.1
1100,2023-04-01,2023-05-01,5256,5587,331,49.65
1100,2023-05-01,2023-05-31,5587,5974,387,58.05
1100,2023-06-01,2023-07-01,5974,6346,372,55.8
1100,2023-07-01,2023-07-31,6346,6517,171,25.65
1100,2023-08-01,2023-08-31,6517,6617,100,15.0
1100,2023-09-01,2023-10-01,6617,6707,90,13.5
1100,2023-10-01,2023-10-31,6707,6865,158,23.7
1100,2023-11-01,2023-12-01,6865,7177,312,46.8
1100,2023-12-01,2023-12-31,7177,7411,234,35.1
1101,2023-01-01,2023-01-31,4714,4970,256,38.4
1101,2023-02-01,2023-03-03,4970,5228,258,38.7
1101,2023-03-01,2023-03-31,5228,5552,324,48.6
1101,2023-04-01,2023-05-01,5552,5930,378,56.7
1101,2023-05-01,2023-05-31,5930,6147,217,32.55
1101,2023-06-01,2023-07-01,6147,6555,408,61.2
1101,2023-07-01,2023-07-31,6555,6670,115,17.25
1101,2023-08-01,2023-08-31,6670,7091,421,63.15
1101,2023-09-01,2023-10-01,7091,7435,344,51.6
1101,2023-10-01,2023-10-31,7435,7525,90,13.5
1101,2023-11-01,2023-12-01,7525,7860,335,50.25
1101,2023-12-01,2023-12-31,7860,8157,297,44.55
1102,2023-01-01,2023-01-31,2189,2490,301,45.15
1102,2023-02-01,2023-03-03,2490,2667,177,26.55
1102,2023-03-01,2023-03-31,2667,2994,327,49.05
1102,2023-04-01,2023-05-01,2994,3222,228,34.2
1102,2023-05-01,2023-05-31,3222,3639,417,62.55
1102,2023-06-01,2023-07-01,3639,3820,181,27.15
1102,2023-07-01,2023-07-31,3820,4157,337,50.55
1102,2023-08-01,2023-08-31,4157,4230,73,10.95
1102,2023-09-01,2023-10-01,4230,4621,391,58.65
1102,2023-10-01,2023-10-31,4621,5110,489,73.35
1102,2023-11-01,2023-12-01,5110,5170,60,9.0
1102,2023-12-01,2023-12-31,5170,5252,82,12.3
1103,2023-01-01,2023-01-31,1035,1309,274,41.1
1103,2023-02-01,2023-03-03,1309,1624,315,47.25
1103,2023-03-01,2023-03-31,1624,2054,430,64.5
1103,2023-04-01,2023-05-01,2054,2303,249,37.35
1103,2023-05-01,2023-05-31,2303,2419,116,17.4
1103,2023-06-01,2023-07-01,2419,2730,311,46.65
1103,2023-07-01,2023-07-31,2730,2885,155,23.25
1103,2023-08-01,2023-08-31,2885,3043,158,23.7
1103,2023-09-01,2023-10-01,3043,3374,331,49.65
1103,2023-10-01,2023-10-31,3374,3774,400,60.0
1103,2023-11-01,2023-12-01,3774,3991,217,32.55
1103,2023-12-01,2023-12-31,3991,4126,135,20.25
1104,2023-01-01,2023-01-31,3874,4237,363,54.45
1104,2023-02-01,2023-03-03,4237,4513,276,41.4
1104,2023-03-01,2023-03-31,4513,4632,119,17.85
1104,2023-04-01,2023-05-01,4632,4817,185,27.75
1104,2023-05-01,2023-05-31,4817,5042,225,33.75
1104,2023-06-01,2023-07-01,5042,5332,290,43.5
1104,2023-07-01,2023-07-31,5332,5493,161,24.15
1104,2023-08-01,2023-08-31,5493,5835,342,51.3
1104,2023-09-01,2023-10-01,5835,6036,201,30.15
1104,2023-10-01,2023-10-31,6036,6417,381,57.15
1104,2023-11-01,2023-12-01,6417,6728,311,46.65
1104,2023-12-01,2023-12-31,6728,7033,305,45.75
1105,2023-01-01,2023-01-31,4207,4572,365,54.75
1105,2023-02-01,2023-03-03,4572,4967,395,59.25
1105,2023-03-01,2023-03-31,4967,5250,283,42.45
1105,2023-04-01,2023-05-01,5250,5544,294,44.1
1105,2023-05-01,2023-05-31,5544,5959,415,62.25
1105,2023-06-01,2023-07-01,5959,6075,116,17.4
1105,2023-07-01,2023-07-31,6075,6237,162,24.3
1105,2023-08-01,2023-08-31,6237,6382,145,21.75
1105,2023-09-01,2023-10-01,6382,6751,369,55.35
1105,2023-10-01,2023-10-31,6751,7169,418,62.7
1105,2023-11-01,2023-12-01,7169,7613,444,66.6
1105,2023-12-01,2023-12-31,7613,7842,229,34.35
1106,2023-01-01,2023-01-31,3196,3565,369,55.35
1106,2023-02-01,2023-03-03,3565,3747,182,27.3
1106,2023-03-01,2023-03-31,3747,3944,197,29.55
1106,2023-04-01,2023-05-01,3944,4050,106,15.9
1106,2023-05-01,2023-05-31,4050,4364,314,47.1
1106,2023-06-01,2023-07-01,4364,4552,188,28.2
1106,2023-07-01,2023-07-31,4552,4902,350,52.5
1106,2023-08-01,2023-08-31,4902,4957,55,8.25
1106,2023-09-01,2023-10-01,4957,5279,322,48.3
1106,2023-10-01,2023-10-31,5279,5383,104,15.6
1106,2023-11-01,2023-12-01,5383,5802,419,62.85
1106,2023-12-01,2023-12-31,5802,6302,500,75.0
1107,2023-01-01,2023-01-31,4054,4386,332,49.8
1107,2023-02-01,2023-03-03,4386,4571,185,27.75
1107,2023-03-01,2023-03-31,4571,4745,174,26.1
1107,2023-04-01,2023-05-01,4745,4898,153,22.95
1107,2023-05-01,2023-05-31,4898,5379,481,72.15
1107,2023-06-01,2023-07-01,5379,5612,233,34.95
1107,2023-07-01,2023-07-31,5612,5842,230,34.5
1107,2023-08-01,2023-08-31,5842,5957,115,17.25
1107,2023-09-01,2023-10-01,5957,6269,312,46.8
1107,2023-10-01,2023-10-31,6269,6742,473,70.95
1107,2023-11-01,2023-12-01,6742,7189,447,67.05
1107,2023-12-01,2023-12-31,7189,7421,232,34.8
1108,2023-01-01,2023-01-31,1977,2234,257,38.55
1108,2023-02-01,2023-03-03,2234,2295,61,9.15
1108,2023-03-01,2023-03-31,2295,2472,177,26.55
1108,2023-04-01,2023-05-01,2472,2597,125,18.75
1108,2023-05-01,2023-05-31,2597,2941,344,51.6
1108,2023-06-01,2023-07-01,2941,3182,241,36.15
1108,2023-07-01,2023-07-31,3182,3237,55,8.25
1108,2023-08-01,2023-08-31,3237,3393,156,23.4
1108,2023-09-01,2023-10-01,3393,3706,313,46.95
1108,2023-10-01,2023-10-31,3706,4103,397,59.55
1108,2023-11-01,2023-12-01,4103,4520,417,62.55
1108,2023-12-01,2023-12-31,4520,4981,461,69.15
1109,2023-01-01,2023-01-31,1329,1571,242,36.3
1109,2023-02-01,2023-03-03,1571,1637,66,9.9
1109,2023-03-01,2023-03-31,1637,1768,131,19.65
1109,2023-04-01,2023-05-01,1768,2081,313,46.95
1109,2023-05-01,2023-05-31,2081,2134,53,7.95
1109,2023-06-01,2023-07-01,2134,2371,237,35.55
1109,2023-07-01,2023-07-31,2371,2475,104,15.6
1109,2023-08-01,2023-08-31,2475,2718,243,36.45
1109,2023-09-01,2023-10-01,2718,2976,258,38.7
1109,2023-10-01,2023-10-31,2976,3392,416,62.4
1109,2023-11-01,2023-12-01,3392,3741,349,52.35
1109,2023-12-01,2023-12-31,3741,4150,409,61.35
1110,2023-01-01,2023-01-31,2104,2345,241,36.15
1110,2023-02-01,2023-03-03,2345,2567,222,33.3
1110,2023-03-01,2023-03-31,2567,3028,461,69.15
1110,2023-04-01,2023-05-01,3028,3215,187,28.05
1110,2023-05-01,2023-05-31,3215,3618,403,60.45
1110,2023-06-01,2023-07-01,3618,4077,459,68.85
1110,2023-07-01,2023-07-31,4077,4521,444,66.6
1110,2023-08-01,2023-08-31,4521,4754,233,34.95
1110,2023-09-01,2023-10-01,4754,4984,230,34.5
1110,2023-10-01,2023-10-31,4984,5365,381,57.15
1110,2023-11-01,2023-12-01,5365,5748,383,57.45
1110,2023-12-01,2023-12-31,5748,6111,363,54.45
1111,2023-01-01,2023-01-31,3181,3582,401,60.15
1111,2023-02-01,2023-03-03,3582,3715,133,19.95
1111,2023-03-01,2023-03-31,3715,4075,360,54.0
1111,2023-04-01,2023-05-01,4075,4340,265,39.75
1111,2023-05-01,2023-05-31,4340,4654,314,47.1
1111,2023-06-01,2023-07-01,4654,4756,102,15.3
1111,2023-07-01,2023-07-31,4756,5042,286,42.9
1111,2023-08-01,2023-08-31,5042,5336,294,44.1
1111,2023-09-01,2023-10-01,5336,5602,266,39.9
1111,2023-10-01,2023-10-31,5602,5924,322,48.3
1111,2023-11-01,2023-12-01,5924,6352,428,64.2
1111,2023-12-01,2023-12-31,6352,6435,83,12.45
1112,2023-01-01,2023-01-31,1702,2026,324,48.6
1112,2023-02-01,2023-03-03,2026,2350,324,48.6
1112,2023-03-01,2023-03-31,2350,2606,256,38.4
1112,2023-04-01,2023-05-01,2606,2874,268,40.2
1112,2023-05-01,2023-05-31,2874,2936,62,9.3
1112,2023-06-01,2023-07-01,2936,3023,87,13.05
1112,2023-07-01,2023-07-31,3023,3475,452,67.8
1112,2023-08-01,2023-08-31,3475,3633,158,23.7
1112,2023-09-01,2023-10-01,3633,3730,97,14.55
1112,2023-10-01,2023-10-31,3730,3976,246,36.9
1112,2023-11-01,2023-12-01,3976,4054,78,11.7
1112,2023-12-01,2023-12-31,4054,4341,287,43.05
1113,2023-01-01,2023-01-31,5000,5445,445,66.75
1113,2023-02-01,2023-03-03,5445,5740,295,44.25
1113,2023-03-01,2023-03-31,5740,5803,63,9.45
1113,2023-04-01,2023-05-01,5803,5912,109,16.35
1113,2023-05-01,2023-05-31,5912,6224,312,46.8
1113,2023-06-01,2023-07-01,6224,6567,343,51.45
1113,2023-07-01,2023-07-31,6567,6736,169,25.35
1113,2023-08-01,2023-08-31,6736,7093,357,53.55
1113,2023-09-01,2023-10-01,7093,7148,55,8.25
1113,2023-10-01,2023-10-31,7148,7363,215,32.25
1113,2023-11-01,2023-12-01,7363,7497,134,20.1
1113,2023-12-01,2023-12-31,7497,7813,316,47.4
1114,2023-01-01,2023-01-31,2079,2253,174,26.1
1114,2023-02-01,2023-03-03,2253,2358,105,15.75
1114,2023-03-01,2023-03-31,2358,2421,63,9.45
1114,2023-04-01,2023-05-01,2421,2906,485,72.75
1114,2023-05-01,2023-05-31,2906,3342,436,65.4
1114,2023-06-01,2023-07-01,3342,3424,82,12.3
1114,2023-07-01,2023-07-31,3424,3520,96,14.4
1114,2023-08-01,2023-08-31,3520,3773,253,37.95
1114,2023-09-01,2023-10-01,3773,3982,209,31.35
1114,2023-10-01,2023-10-31,3982,4449,467,70.05
1114,2023-11-01,2023-12-01,4449,4529,80,12.0
1114,2023-12-01,2023-12-31,4529,4697,168,25.2
1115,2023-01-01,2023-01-31,2982,3419,437,65.55
1115,2023-02-01,2023-03-03,3419,3774,355,53.25
1115,2023-03-01,2023-03-31,3774,3869,95,14.25
1115,2023-04-01,2023-05-01,3869,3919,50,7.5
1115,2023-05-01,2023-05-31,3919,4388,469,70.35
1115,2023-06-01,2023-07-01,4388,4682,294,44.1
1115,2023-07-01,2023-07-31,4682,4976,294,44.1
1115,2023-08-01,2023-08-31,4976,5187,211,31.65
1115,2023-09-01,2023-10-01,5187,5290,103,15.45
1115,2023-10-01,2023-10-31,5290,5569,279,41.85
1115,2023-11-01,2023-12-01,5569,5663,94,14.1
1115,2023-12-01,2023-12-31,5663,5887,224,33.6
1116,2023-01-01,2023-01-31,4619,4931,312,46.8
1116,2023-02-01,2023-03-03,4931,5052,121,18.15
1116,2023-03-01,2023-03-31,5052,5237,185,27.75
1116,2023-04-01,2023-05-01,5237,5705,468,70.2
1116,2023-05-01,2023-05-31,5705,6021,316,47.4
1116,2023-06-01,2023-07-01,6021,6153,132,19.8
1116,2023-07-01,2023-07-31,6153,6366,213,31.95
1116,2023-08-01,2023-08-31,6366,6534,168,25.2
1116,2023-09-01,2023-10-01,6534,6803,269,40.35
1116,2023-10-01,2023-10-31,6803,6924,121,18.15
1116,2023-11-01,2023-12-01,6924,7137,213,31.95
1116,2023-12-01,2023-12-31,7137,7438,301,45.15
1117,2023-01-01,2023-01-31,1754,1995,241,36.15
1117,2023-02-01,2023-03-03,1995,2222,227,34.05
1117,2023-03-01,2023-03-31,2222,2404,182,27.3
1117,2023-04-01,2023-05-01,2404,2785,381,57.15
1117,2023-05-01,2023-05-31,2785,3262,477,71.55
1117,2023-06-01,2023-07-01,3262,3371,109,16.35
1117,2023-07-01,2023-07-31,3371,3667,296,44.4
1117,2023-08-01,2023-08-31,3667,3809,142,21.3
1117,2023-09-01,2023-10-01,3809,4012,203,30.45
1117,2023-10-01,2023-10-31,4012,4129,117,17.55
1117,2023-11-01,2023-12-01,4129,4535,406,60.9
1117,2023-12-01,2023-12-31,4535,4810,275,41.25
1118,2023-01-01,2023-01-31,1729,2157,428,64.2
1118,2023-02-01,2023-03-03,2157,2242,85,12.75
1118,2023-03-01,2023-03-31,2242,2634,392,58.8
1118,2023-04-01,2023-05-01,2634,2761,127,19.05
1118,2023-05-01,2023-05-31,2761,2949,188,28.2
1118,2023-06-01,2023-07-01,2949,3202,253,37.95
1118,2023-07-01,2023-07-31,3202,3557,355,53.25
1118,2023-08-01,2023-08-31,3557,3770,213,31.95
1118,2023-09-01,2023-10-01,3770,3839,69,10.35
1118,2023-10-01,2023-10-31,3839,4245,406,60.9
1118,2023-11-01,2023-12-01,4245,4635,390,58.5
1118,2023-12-01,2023-12-31,4635,4998,363,54.45
1119,2023-01-01,2023-01-31,2782,3042,260,39.0
1119,2023-02-01,2023-03-03,3042,3515,473,70.95
1119,2023-03-01,2023-03-31,3515,3827,312,46.8
1119,2023-04-01,2023-05-01,3827,4105,278,41.7
1119,2023-05-01,2023-05-31,4105,4214,109,16.35
1119,2023-06-01,2023-07-01,4214,4321,107,16.05
1119,2023-07-01,2023-07-31,4321,4537,216,32.4
1119,2023-08-01,2023-08-31,4537,4797,260,39.0
1119,2023-09-01,2023-10-01,4797,5079,282,42.3
1119,2023-10-01,2023-10-31,5079,5568,489,73.35
1119,2023-11-01,2023-12-01,5568,5791,223,33.45
1119,2023-12-01,2023-12-31,5791,6200,409,61.35
1120,2023-01-01,2023-01-31,2453,2515,62,9.3
1120,2023-02-01,2023-03-03,2515,3014,499,74.85
1120,2023-03-01,2023-03-31,3014,3110,96,14.4
1120,2023-04-01,2023-05-01,3110,3244,134,20.1
1120,2023-05-01,2023-05-31,3244,3713,469,70.35
1120,2023-06-01,2023-07-01,3713,4021,308,46.2
1120,2023-07-01,2023-07-31,4021,4362,341,51.15
1120,2023-08-01,2023-08-31,4362,4660,298,44.7
1120,2023-09-01,2023-10-01,4660,4916,256,38.4
1120,2023-10-01,2023-10-31,4916,5382,466,69.9
1120,2023-11-01,2023-12-01,5382,5455,73,10.95
1120,2023-12-01,2023-12-31,5455,5742,287,43.05
1121,2023-01-01,2023-01-31,1080,1354,274,41.1
1121,2023-02-01,2023-03-03,1354,1715,361,54.15
1121,2023-03-01,2023-03-31,1715,2032,317,47.55
1121,2023-04-01,2023-05-01,2032,2505,473,70.95
1121,2023-05-01,2023-05-31,2505,3002,497,74.55
1121,2023-06-01,2023-07-01,3002,3457,455,68.25
1121,2023-07-01,2023-07-31,3457,3607,150,22.5
1121,2023-08-01,2023-08-31,3607,3673,66,9.9
1121,2023-09-01,2023-10-01,3673,3941,268,40.2
1121,2023-10-01,2023-10-31,3941,4440,499,74.85
1121,2023-11-01,2023-12-01,4440,4887,447,67.05
1121,2023-12-01,2023-12-31,4887,5081,194,29.1
1122,2023-01-01,2023-01-31,3798,4000,202,30.3
1122,2023-02-01,2023-03-03,4000,4432,432,64.8
1122,2023-03-01,2023-03-31,4432,4734,302,45.3
1122,2023-04-01,2023-05-01,4734,4997,263,39.45
1122,2023-05-01,2023-05-31,4997,5313,316,47.4
1122,2023-06-01,2023-07-01,5313,5790,477,71.55
1122,2023-07-01,2023-07-31,5790,6204,414,62.1
1122,2023-08-01,2023-08-31,6204,6309,105,15.75
1122,2023-09-01,2023-10-01,6309,6786,477,71.55
1122,2023-10-01,2023-10-31,6786,6969,183,27.45
1122,2023-11-01,2023-12-01,6969,7221,252,37.8
1122,2023-12-01,2023-12-31,7221,7278,57,8.55
1123,2023-01-01,2023-01-31,3757,4017,260,39.0
1123,2023-02-01,2023-03-03,4017,4195,178,26.7
1123,2023-03-01,2023-03-31,4195,4590,395,59.25
1123,2023-04-01,2023-05-01,4590,5005,415,62.25
1123,2023-05-01,2023-05-31,5005,5402,397,59.55
1123,2023-06-01,2023-07-01,5402,5836,434,65.1
1123,2023-07-01,2023-07-31,5836,6045,209,31.35
1123,2023-08-01,2023-08-31,6045,6143,98,14.7
1123,2023-09-01,2023-10-01,6143,6453,310,46.5
1123,2023-10-01,2023-10-31,6453,6681,228,34.2
1123,2023-11-01,2023-12-01,6681,7000,319,47.85
1123,2023-12-01,2023-12-31,7000,7477,477,71.55
1124,2023-01-01,2023-01-31,2010,2377,367,55.05
1124,2023-02-01,2023-03-03,2377,2442,65,9.75
1124,2023-03-01,2023-03-31,2442,2646,204,30.6
1124,2023-04-01,2023-05-01,2646,2894,248,37.2
1124,2023-05-01,2023-05-31,2894,2969,75,11.25
1124,2023-06-01,2023-07-01,2969,3242,273,40.95
1124,2023-07-01,2023-07-31,3242,3712,470,70.5
1124,2023-08-01,2023-08-31,3712,3855,143,21.45
1124,2023-09-01,2023-10-01,3855,3940,85,12.75
1124,2023-10-01,2023-10-31,3940,4315,375,56.25
1124,2023-11-01,2023-12-01,4315,4728,413,61.95
1124,2023-12-01,2023-12-31,4728,5061,333,49.95
1125,2023-01-01,2023-01-31,3866,4196,330,49.5
1125,2023-02-01,2023-03-03,4196,4632,436,65.4
1125,2023-03-01,2023-03-31,4632,4890,258,38.7
1125,2023-04-01,2023-05-01,4890,5225,335,50.25
1125,2023-05-01,2023-05-31,5225,5679,454,68.1
1125,2023-06-01,2023-07-01,5679,6135,456,68.4
1125,2023-07-01,2023-07-31,6135,6412,277,41.55
1125,2023-08-01,2023-08-31,6412,6598,186,27.9
1125,2023-09-01,2023-10-01,6598,6900,302,45.3
1125,2023-10-01,2023-10-31,6900,7124,224,33.6
1125,2023-11-01,2023-12-01,7124,7276,152,22.8
1125,2023-12-01,2023-12-31,7276,7428,152,22.8
1126,2023-01-01,2023-01-31,2663,2812,149,22.35
1126,2023-02-01,2023-03-03,2812,3008,196,29.4
1126,2023-03-01,2023-03-31,3008,3256,248,37.2
1126,2023-04-01,2023-05-01,3256,3651,395,59.25
1126,2023-05-01,2023-05-31,3651,3707,56,8.4
1126,2023-06-01,2023-07-01,3707,4143,436,65.4
1126,2023-07-01,2023-07-31,4143,4338,195,29.25
1126,2023-08-01,2023-08-31,4338,4661,323,48.45
1126,2023-09-01,2023-10-01,4661,4979,318,47.7
1126,2023-10-01,2023-10-31,4979,5357,378,56.7
1126,2023-11-01,2023-12-01,5357,5776,419,62.85
1126,2023-12-01,2023-12-31,5776,6036,260,39.0
1127,2023-01-01,2023-01-31,2059,2300,241,36.15
1127,2023-02-01,2023-03-03,2300,2507,207,31.05
1127,2023-03-01,2023-03-31,2507,2563,56,8.4
1127,2023-04-01,2023-05-01,2563,2894,331,49.65
1127,2023-05-01,2023-05-31,2894,3001,107,16.05
1127,2023-06-01,2023-07-01,3001,3099,98,14.7
1127,2023-07-01,2023-07-31,3099,3435,336,50.4
1127,2023-08-01,2023-08-31,3435,3502,67,10.05
1127,2023-09-01,2023-10-01,3502,3940,438,65.7
1127,2023-10-01,2023-10-31,3940,4102,162,24.3
1127,2023-11-01,2023-12-01,4102,4577,475,71.25
1127,2023-12-01,2023-12-31,4577,4846,269,40.35
1128,2023-01-01,2023-01-31,3303,3445,142,21.3
1128,2023-02-01,2023-03-03,3445,3703,258,38.7
1128,2023-03-01,2023-03-31,3703,3945,242,36.3
1128,2023-04-01,2023-05-01,3945,4367,422,63.3
1128,2023-05-01,2023-05-31,4367,4585,218,32.7
1128,2023-06-01,2023-07-01,4585,4707,122,18.3
1128,2023-07-01,2023-07-31,4707,5107,400,60.0
1128,2023-08-01,2023-08-31,5107,5268,161,24.15
1128,2023-09-01,2023-10-01,5268,5730,462,69.3
1128,2023-10-01,2023-10-31,5730,6050,320,48.0
1128,2023-11-01,2023-12-01,6050,6305,255,38.25
1128,2023-12-01,2023-12-31,6305,6499,194,29.1
1129,2023-01-01,2023-01-31,1647,1998,351,52.65
1129,2023-02-01,2023-03-03,1998,2333,335,50.25
1129,2023-03-01,2023-03-31,2333,2437,104,15.6
1129,2023-04-01,2023-05-01,2437,2552,115,17.25
1129,2023-05-01,2023-05-31,2552,2623,71,10.65
1129,2023-06-01,2023-07-01,2623,2926,303,45.45
1129,2023-07-01,2023-07-31,2926,3044,118,17.7
1129,2023-08-01,2023-08-31,3044,3366,322,48.3
1129,2023-09-01,2023-10-01,3366,3765,399,59.85
1129,2023-10-01,2023-10-31,3765,3947,182,27.3
1129,2023-11-01,2023-12-01,3947,4183,236,35.4
1129,2023-12-01,2023-12-31,4183,4599,416,62.4
1130,2023-01-01,2023-01-31,2963,3249,286,42.9
1130,2023-02-01,2023-03-03,3249,3457,208,31.2
1130,2023-03-01,2023-03-31,3457,3586,129,19.35
1130,2023-04-01,2023-05-01,3586,3946,360,54.0
1130,2023-05-01,2023-05-31,3946,4157,211,31.65
1130,2023-06-01,2023-07-01,4157,4536,379,56.85
1130,2023-07-01,2023-07-31,4536,4606,70,10.5
1130,2023-08-01,2023-08-31,4606,5045,439,65.85
1130,2023-09-01,2023-10-01,5045,5220,175,26.25
1130,2023-10-01,2023-10-31,5220,5715,495,74.25
1130,2023-11-01,2023-12-01,5715,6048,333,49.95
1130,2023-12-01,2023-12-31,6048,6301,253,37.95
1131,2023-01-01,2023-01-31,1719,1788,69,10.35
1131,2023-02-01,2023-03-03,1788,2085,297,44.55
1131,2023-03-01,2023-03-31,2085,2208,123,18.45
1131,2023-04-01,2023-05-01,2208,2549,341,51.15
1131,2023-05-01,2023-05-31,2549,2763,214,32.1
1131,2023-06-01,2023-07-01,2763,3236,473,70.95
1131,2023-07-01,2023-07-31,3236,3379,143,21.45
1131,2023-08-01,2023-08-31,3379,3609,230,34.5
1131,2023-09-01,2023-10-01,3609,3753,144,21.6
1131,2023-10-01,2023-10-31,3753,4247,494,74.1
1131,2023-11-01,2023-12-01,4247,4355,108,16.2
1131,2023-12-01,2023-12-31,4355,4719,364,54.6
1132,2023-01-01,2023-01-31,4449,4721,272,40.8
1132,2023-02-01,2023-03-03,4721,5013,292,43.8
1132,2023-03-01,2023-03-31,5013,5094,81,12.15
1132,2023-04-01,2023-05-01,5094,5261,167,25.05
1132,2023-05-01,2023-05-31,5261,5479,218,32.7
1132,2023-06-01,2023-07-01,5479,5670,191,28.65
1132,2023-07-01,2023-07-31,5670,6130,460,69.0
1132,2023-08-01,2023-08-31,6130,6607,477,71.55
1132,2023-09-01,2023-10-01,6607,7105,498,74.7
1132,2023-10-01,2023-10-31,7105,7578,473,70.95
1132,2023-11-01,2023-12-01,7578,8028,450,67.5
1132,2023-12-01,2023-12-31,8028,8377,349,52.35
1133,2023-01-01,2023-01-31,1667,2090,423,63.45
1133,2023-02-01,2023-03-03,2090,2270,180,27.0
1133,2023-03-01,2023-03-31,2270,2692,422,63.3
1133,2023-04-01,2023-05-01,2692,2885,193,28.95
1133,2023-05-01,2023-05-31,2885,3000,115,17.25
1133,2023-06-01,2023-07-01,3000,3465,465,69.75
1133,2023-07-01,2023-07-31,3465,3642,177,26.55
1133,2023-08-01,2023-08-31,3642,3778,136,20.4
1133,2023-09-01,2023-10-01,3778,4034,256,38.4
1133,2023-10-01,2023-10-31,4034,4372,338,50.7
1133,2023-11-01,2023-12-01,4372,4459,87,13.05
1133,2023-12-01,2023-12-31,4459,4925,466,69.9
1134,2023-01-01,2023-01-31,4162,4565,403,60.45
1134,2023-02-01,2023-03-03,4565,4845,280,42.0
1134,2023-03-01,2023-03-31,4845,5137,292,43.8
1134,2023-04-01,2023-05-01,5137,5353,216,32.4
1134,2023-05-01,2023-05-31,5353,5604,251,37.65
1134,2023-06-01,2023-07-01,5604,5853,249,37.35
1134,2023-07-01,2023-07-31,5853,6126,273,40.95
1134,2023-08-01,2023-08-31,6126,6367,241,36.15
1134,2023-09-01,2023-10-01,6367,6519,152,22.8
1134,2023-10-01,2023-10-31,6519,6885,366,54.9
1134,2023-11-01,2023-12-01,6885,6944,59,8.85
1134,2023-12-01,2023-12-31,6944,7318,374,56.1
1135,2023-01-01,2023-01-31,2435,2734,299,44.85
1135,2023-02-01,2023-03-03,2734,3168,434,65.1
1135,2023-03-01,2023-03-31,3168,3530,362,54.3
1135,2023-04-01,2023-05-01,3530,3991,461,69.15
1135,2023-05-01,2023-05-31,3991,4474,483,72.45
1135,2023-06-01,2023-07-01,4474,4595,121,18.15
1135,2023-07-01,2023-07-31,4595,5063,468,70.2
1135,2023-08-01,2023-08-31,5063,5275,212,31.8
1135,2023-09-01,2023-10-01,5275,5708,433,64.95
1135,2023-10-01,2023-10-31,5708,5968,260,39.0
1135,2023-11-01,2023-12-01,5968,6353,385,57.75
1135,2023-12-01,2023-12-31,6353,6751,398,59.7
1136,2023-01-01,2023-01-31,1501,1753,252,37.8
1136,2023-02-01,2023-03-03,1753,1822,69,10.35
1136,2023-03-01,2023-03-31,1822,2027,205,30.75
1136,2023-04-01,2023-05-01,2027,2214,187,28.05
1136,2023-05-01,2023-05-31,2214,2392,178,26.7
1136,2023-06-01,2023-07-01,2392,2570,178,26.7
1136,2023-07-01,2023-07-31,2570,2630,60,9.0
1136,2023-08-01,2023-08-31,2630,3117,487,73.05
1136,2023-09-01,2023-10-01,3117,3568,451,67.65
1136,2023-10-01,2023-10-31,3568,3848,280,42.0
1136,2023-11-01,2023-12-01,3848,4106,258,38.7
1136,2023-12-01,2023-12-31,4106,4423,317,47.55
1137,2023-01-01,2023-01-31,1974,2463,489,73.35
1137,2023-02-01,2023-03-03,2463,2535,72,10.8
1137,2023-03-01,2023-03-31,2535,2834,299,44.85
1137,2023-04-01,2023-05-01,2834,3042,208,31.2
1137,2023-05-01,2023-05-31,3042,3459,417,62.55
1137,2023-06-01,2023-07-01,3459,3582,123,18.45
1137,2023-07-01,2023-07-31,3582,3995,413,61.95
1137,2023-08-01,2023-08-31,3995,4383,388,58.2
1137,2023-09-01,2023-10-01,4383,4486,103,15.45
1137,2023-10-01,2023-10-31,4486,4699,213,31.95
1137,2023-11-01,2023-12-01,4699,4758,59,8.85
1137,2023-12-01,2023-12-31,4758,5204,446,66.9
1138,2023-01-01,2023-01-31,4300,4489,189,28.35
1138,2023-02-01,2023-03-03,4489,4884,395,59.25
1138,2023-03-01,2023-03-31,4884,5253,369,55.35
1138,2023-04-01,2023-05-01,5253,5390,137,20.55
1138,2023-05-01,2023-05-31,5390,5460,70,10.5
1138,2023-06-01,2023-07-01,5460,5637,177,26.55
1138,2023-07-01,2023-07-31,5637,5730,93,13.95
1138,2023-08-01,2023-08-31,5730,5855,125,18.75
1138,2023-09-01,2023-10-01,5855,6194,339,50.85
1138,2023-10-01,2023-10-31,6194,6305,111,16.65
1138,2023-11-01,2023-12-01,6305,6668,363,54.45
1138,2023-12-01,2023-12-31,6668,6924,256,38.4
1139,2023-01-01,2023-01-31,2922,3114,192,28.8
1139,2023-02-01,2023-03-03,3114,3188,74,11.1
1139,2023-03-01,2023-03-31,3188,3642,454,68.1
1139,2023-04-01,2023-05-01,3642,3892,250,37.5
1139,2023-05-01,2023-05-31,3892,4168,276,41.4
1139,2023-06-01,2023-07-01,4168,4553,385,57.75
1139,2023-07-01,2023-07-31,4553,4824,271,40.65
1139,2023-08-01,2023-08-31,4824,5089,265,39.75
1139,2023-09-01,2023-10-01,5089,5391,302,45.3
1139,2023-10-01,2023-10-31,5391,5457,66,9.9
1139,2023-11-01,2023-12-01,5457,5914,457,68.55
1139,2023-12-01,2023-12-31,5914,5982,68,10.2
1140,2023-01-01,2023-01-31,4103,4505,402,60.3
1140,2023-02-01,2023-03-03,4505,4808,303,45.45
1140,2023-03-01,2023-03-31,4808,4879,71,10.65
1140,2023-04-01,2023-05-01,4879,5342,463,69.45
1140,2023-05-01,2023-05-31,5342,5511,169,25.35
1140,2023-06-01,2023-07-01,5511,5652,141,21.15
1140,2023-07-01,2023-07-31,5652,5875,223,33.45
1140,2023-08-01,2023-08-31,5875,6119,244,36.6
1140,2023-09-01,2023-10-01,6119,6283,164,24.6
1140,2023-10-01,2023-10-31,6283,6376,93,13.95
1140,2023-11-01,2023-12-01,6376,6839,463,69.45
1140,2023-12-01,2023-12-31,6839,7161,322,48.3
1141,2023-01-01,2023-01-31,3953,4405,452,67.8
1141,2023-02-01,2023-03-03,4405,4885,480,72.0
1141,2023-03-01,2023-03-31,4885,5018,133,19.95
1141,2023-04-01,2023-05-01,5018,5141,123,18.45
1141,2023-05-01,2023-05-31,5141,5613,472,70.8
1141,2023-06-01,2023-07-01,5613,5675,62,9.3
1141,2023-07-01,2023-07-31,5675,5810,135,20.25
1141,2023-08-01,2023-08-31,5810,6167,357,53.55
1141,2023-09-01,2023-10-01,6167,6388,221,33.15
1141,2023-10-01,2023-10-31,6388,6816,428,64.2
1141,2023-11-01,2023-12-01,6816,7048,232,34.8
1141,2023-12-01,2023-12-31,7048,7478,430,64.5
1142,2023-01-01,2023-01-31,2295,2579,284,42.6
1142,2023-02-01,2023-03-03,2579,2823,244,36.6
1142,2023-03-01,2023-03-31,2823,3130,307,46.05
1142,2023-04-01,2023-05-01,3130,3274,144,21.6
1142,2023-05-01,2023-05-31,3274,3596,322,48.3
1142,2023-06-01,2023-07-01,3596,4092,496,74.4
1142,2023-07-01,2023-07-31,4092,4270,178,26.7
1142,2023-08-01,2023-08-31,4270,4447,177,26.55
1142,2023-09-01,2023-10-01,4447,4632,185,27.75
1142,2023-10-01,2023-10-31,4632,4771,139,20.85
1142,2023-11-01,2023-12-01,4771,4826,55,8.25
1142,2023-12-01,2023-12-31,4826,5040,214,32.1
1143,2023-01-01,2023-01-31,3479,3941,462,69.3
1143,2023-02-01,2023-03-03,3941,4086,145,21.75
1143,2023-03-01,2023-03-31,4086,4563,477,71.55
1143,2023-04-01,2023-05-01,4563,5053,490,73.5
1143,2023-05-01,2023-05-31,5053,5507,454,68.1
1143,2023-06-01,2023-07-01,5507,5710,203,30.45
1143,2023-07-01,2023-07-31,5710,5841,131,19.65
1143,2023-08-01,2023-08-31,5841,6073,232,34.8
1143,2023-09-01,2023-10-01,6073,6373,300,45.0
1143,2023-10-01,2023-10-31,6373,6525,152,22.8
1143,2023-11-01,2023-12-01,6525,7009,484,72.6
1143,2023-12-01,2023-12-31,7009,7319,310,46.5
1144,2023-01-01,2023-01-31,1457,1650,193,28.95
1144,2023-02-01,2023-03-03,1650,1932,282,42.3
1144,2023-03-01,2023-03-31,1932,2039,107,16.05
1144,2023-04-01,2023-05-01,2039,2518,479,71.85
1144,2023-05-01,2023-05-31,2518,2695,177,26.55
1144,2023-06-01,2023-07-01,2695,2990,295,44.25
1144,2023-07-01,2023-07-31,2990,3056,66,9.9
1144,2023-08-01,2023-08-31,3056,3386,330,49.5
1144,2023-09-01,2023-10-01,3386,3720,334,50.1
1144,2023-10-01,2023-10-31,3720,4178,458,68.7
1144,2023-11-01,2023-12-01,4178,4316,138,20.7
1144,2023-12-01,2023-12-31,4316,4456,140,21.0
1145,2023-01-01,2023-01-31,1577,1929,352,52.8
1145,2023-02-01,2023-03-03,1929,1995,66,9.9
1145,2023-03-01,2023-03-31,1995,2319,324,48.6
1145,2023-04-01,2023-05-01,2319,2509,190,28.5
1145,2023-05-01,2023-05-31,2509,2758,249,37.35
1145,2023-06-01,2023-07-01,2758,3035,277,41.55
1145,2023-07-01,2023-07-31,3035,3152,117,17.55
1145,2023-08-01,2023-08-31,3152,3509,357,53.55
1145,2023-09-01,2023-10-01,3509,3587,78,11.7
1145,2023-10-01,2023-10-31,3587,4058,471,70.65
1145,2023-11-01,2023-12-01,4058,4470,412,61.8
1145,2023-12-01,2023-12-31,4470,4603,133,19.95
1146,2023-01-01,2023-01-31,2126,2352,226,33.9
1146,2023-02-01,2023-03-03,2352,2436,84,12.6
1146,2023-03-01,2023-03-31,2436,2901,465,69.75
1146,2023-04-01,2023-05-01,2901,2955,54,8.1
1146,2023-05-01,2023-05-31,2955,3184,229,34.35
1146,2023-06-01,2023-07-01,3184,3619,435,65.25
1146,2023-07-01,2023-07-31,3619,3688,69,10.35
1146,2023-08-01,2023-08-31,3688,4061,373,55.95
1146,2023-09-01,2023-10-01,4061,4265,204,30.6
1146,2023-10-01,2023-10-31,4265,4363,98,14.7
1146,2023-11-01,2023-12-01,4363,4468,105,15.75
1146,2023-12-01,2023-12-31,4468,4585,117,17.55
1147,2023-01-01,2023-01-31,1191,1481,290,43.5
1147,2023-02-01,2023-03-03,1481,1696,215,32.25
1147,2023-03-01,2023-03-31,1696,1802,106,15.9
1147,2023-04-01,2023-05-01,1802,1885,83,12.45
1147,2023-05-01,2023-05-31,1885,2171,286,42.9
1147,2023-06-01,2023-07-01,2171,2533,362,54.3
1147,2023-07-01,2023-07-31,2533,2729,196,29.4
1147,2023-08-01,2023-08-31,2729,2913,184,27.6
1147,2023-09-01,2023-10-01,2913,3053,140,21.0
1147,2023-10-01,2023-10-31,3053,3365,312,46.8
1147,2023-11-01,2023-12-01,3365,3560,195,29.25
1147,2023-12-01,2023-12-31,3560,3683,123,18.45
1148,2023-01-01,2023-01-31,3624,4002,378,56.7
1148,2023-02-01,2023-03-03,4002,4291,289,43.35
1148,2023-03-01,2023-03-31,4291,4420,129,19.35
1148,2023-04-01,2023-05-01,4420,4908,488,73.2
1148,2023-05-01,2023-05-31,4908,5172,264,39.6
1148,2023-06-01,2023-07-01,5172,5596,424,63.6
1148,2023-07-01,2023-07-31,5596,5765,169,25.35
1148,2023-08-01,2023-08-31,5765,5903,138,20.7
1148,2023-09-01,2023-10-01,5903,6009,106,15.9
1148,2023-10-01,2023-10-31,6009,6083,74,11.1
1148,2023-11-01,2023-12-01,6083,6491,408,61.2
1148,2023-12-01,2023-12-31,6491,6624,133,19.95
1149,2023-01-01,2023-01-31,4119,4208,89,13.35
1149,2023-02-01,2023-03-03,4208,4349,141,21.15
1149,2023-03-01,2023-03-31,4349,4599,250,37.5
1149,2023-04-01,2023-05-01,4599,4660,61,9.15
1149,2023-05-01,2023-05-31,4660,4793,133,19.95
1149,2023-06-01,2023-07-01,4793,5202,409,61.35
1149,2023-07-01,2023-07-31,5202,5433,231,34.65
1149,2023-08-01,2023-08-31,5433,5589,156,23.4
1149,2023-09-01,2023-10-01,5589,5679,90,13.5
1149,2023-10-01,2023-10-31,5679,6132,453,67.95
1149,2023-11-01,2023-12-01,6132,6539,407,61.05
1149,2023-12-01,2023-12-31,6539,6684,145,21.75
1150,2023-01-01,2023-01-31,4519,4912,393,58.95
1150,2023-02-01,2023-03-03,4912,5227,315,47.25
1150,2023-03-01,2023-03-31,5227,5561,334,50.1
1150,2023-04-01,2023-05-01,5561,5861,300,45.0
1150,2023-05-01,2023-05-31,5861,6240,379,56.85
1150,2023-06-01,2023-07-01,6240,6335,95,14.25
1150,2023-07-01,2023-07-31,6335,6734,399,59.85
1150,2023-08-01,2023-08-31,6734,6789,55,8.25
1150,2023-09-01,2023-10-01,6789,7126,337,50.55
1150,2023-10-01,2023-10-31,7126,7282,156,23.4
1150,2023-11-01,2023-12-01,7282,7620,338,50.7
1150,2023-12-01,2023-12-31,7620,7693,73,10.95
1151,2023-01-01,2023-01-31,1511,1941,430,64.5
1151,2023-02-01,2023-03-03,1941,2177,236,35.4
1151,2023-03-01,2023-03-31,2177,2446,269,40.35
1151,2023-04-01,2023-05-01,2446,2549,103,15.45
1151,2023-05-01,2023-05-31,2549,2942,393,58.95
1151,2023-06-01,2023-07-01,2942,2999,57,8.55
1151,2023-07-01,2023-07-31,2999,3224,225,33.75
1151,2023-08-01,2023-08-31,3224,3602,378,56.7
1151,2023-09-01,2023-10-01,3602,4075,473,70.95
1151,2023-10-01,2023-10-31,4075,4254,179,26.85
1151,2023-11-01,2023-12-01,4254,4532,278,41.7
1151,2023-12-01,2023-12-31,4532,4912,380,57.0
1152,2023-01-01,2023-01-31,4025,4195,170,25.5
1152,2023-02-01,2023-03-03,4195,4326,131,19.65
1152,2023-03-01,2023-03-31,4326,4588,262,39.3
1152,2023-04-01,2023-05-01,4588,4746,158,23.7
1152,2023-05-01,2023-05-31,4746,4864,118,17.7
1152,2023-06-01,2023-07-01,4864,4924,60,9.0
1152,2023-07-01,2023-07-31,4924,5148,224,33.6
1152,2023-08-01,2023-08-31,5148,5616,468,70.2
1152,2023-09-01,2023-10-01,5616,5937,321,48.15
1152,2023-10-01,2023-10-31,5937,6213,276,41.4
1152,2023-11-01,2023-12-01,6213,6542,329,49.35
1152,2023-12-01,2023-12-31,6542,7023,481,72.15
1153,2023-01-01,2023-01-31,1280,1382,102,15.3
1153,2023-02-01,2023-03-03,1382,1602,220,33.0
1153,2023-03-01,2023-03-31,1602,1806,204,30.6
1153,2023-04-01,2023-05-01,1806,2037,231,34.65
1153,2023-05-01,2023-05-31,2037,2300,263,39.45
1153,2023-06-01,2023-07-01,2300,2593,293,43.95
1153,2023-07-01,2023-07-31,2593,2780,187,28.05
1153,2023-08-01,2023-08-31,2780,3080,300,45.0
1153,2023-09-01,2023-10-01,3080,3396,316,47.4
1153,2023-10-01,2023-10-31,3396,3727,331,49.65
1153,2023-11-01,2023-12-01,3727,4121,394,59.1
1153,2023-12-01,2023-12-31,4121,4302,181,27.15
1154,2023-01-01,2023-01-31,2882,3135,253,37.95
1154,2023-02-01,2023-03-03,3135,3246,111,16.65
1154,2023-03-01,2023-03-31,3246,3741,495,74.25
1154,2023-04-01,2023-05-01,3741,3898,157,23.55
1154,2023-05-01,2023-05-31,3898,3960,62,9.3
1154,2023-06-01,2023-07-01,3960,4444,484,72.6
1154,2023-07-01,2023-07-31,4444,4660,216,32.4
1154,2023-08-01,2023-08-31,4660,5108,448,67.2
1154,2023-09-01,2023-10-01,5108,5468,360,54.0
1154,2023-10-01,2023-10-31,5468,5671,203,30.45
1154,2023-11-01,2023-12-01,5671,6087,416,62.4
1154,2023-12-01,2023-12-31,6087,6432,345,51.75
1155,2023-01-01,2023-01-31,3971,4351,380,57.0
1155,2023-02-01,2023-03-03,4351,4425,74,11.1
1155,2023-03-01,2023-03-31,4425,4625,200,30.0
1155,2023-04-01,2023-05-01,4625,4855,230,34.5
1155,2023-05-01,2023-05-31,4855,5211,356,53.4
1155,2023-06-01,2023-07-01,5211,5369,158,23.7
1155,2023-07-01,2023-07-31,5369,5458,89,13.35
1155,2023-08-01,2023-08-31,5458,5515,57,8.55
1155,2023-09-01,2023-10-01,5515,5921,406,60.9
1155,2023-10-01,2023-10-31,5921,6229,308,46.2
1155,2023-11-01,2023-12-01,6229,6647,418,62.7
1155,2023-12-01,2023-12-31,6647,6754,107,16.05
1156,2023-01-01,2023-01-31,4495,4891,396,59.4
1156,2023-02-01,2023-03-03,4891,4949,58,8.7
1156,2023-03-01,2023-03-31,4949,5056,107,16.05
1156,2023-04-01,2023-05-01,5056,5492,436,65.4
1156,2023-05-01,2023-05-31,5492,5797,305,45.75
1156,2023-06-01,2023-07-01,5797,6069,272,40.8
1156,2023-07-01,2023-07-31,6069,6415,346,51.9
1156,2023-08-01,2023-08-31,6415,6741,326,48.9
1156,2023-09-01,2023-10-01,6741,7223,482,72.3
1156,2023-10-01,2023-10-31,7223,7671,448,67.2
1156,2023-11-01,2023-12-01,7671,7889,218,32.7
1156,2023-12-01,2023-12-31,7889,8200,311,46.65
1157,2023-01-01,2023-01-31,3379,3752,373,55.95
1157,2023-02-01,2023-03-03,3752,3974,222,33.3
1157,2023-03-01,2023-03-31,3974,4066,92,13.8
1157,2023-04-01,2023-05-01,4066,4174,108,16.2
1157,2023-05-01,2023-05-31,4174,4228,54,8.1
1157,2023-06-01,2023-07-01,4228,4576,348,52.2
1157,2023-07-01,2023-07-31,4576,4643,67,10.05
1157,2023-08-01,2023-08-31,4643,4776,133,19.95
1157,2023-09-01,2023-10-01,4776,4864,88,13.2
1157,2023-10-01,2023-10-31,4864,5245,381,57.15
1157,2023-11-01,2023-12-01,5245,5555,310,46.5
1157,2023-12-01,2023-12-31,5555,5742,187,28.05
1158,2023-01-01,2023-01-31,3950,4045,95,14.25
1158,2023-02-01,2023-03-03,4045,4299,254,38.1
1158,2023-03-01,2023-03-31,4299,4648,349,52.35
1158,2023-04-01,2023-05-01,4648,4811,163,24.45
1158,2023-05-01,2023-05-31,4811,5043,232,34.8
1158,2023-06-01,2023-07-01,5043,5179,136,20.4
1158,2023-07-01,2023-07-31,5179,5655,476,71.4
1158,2023-08-01,2023-08-31,5655,5901,246,36.9
1158,2023-09-01,2023-10-01,5901,6144,243,36.45
1158,2023-10-01,2023-10-31,6144,6600,456,68.4
1158,2023-11-01,2023-12-01,6600,6941,341,51.15
1158,2023-12-01,2023-12-31,6941,7115,174,26.1
1159,2023-01-01,2023-01-31,4213,4290,77,11.55
1159,2023-02-01,2023-03-03,4290,4528,238,35.7
1159,2023-03-01,2023-03-31,4528,5022,494,74.1
1159,2023-04-01,2023-05-01,5022,5313,291,43.65
1159,2023-05-01,2023-05-31,5313,5605,292,43.8
1159,2023-06-01,2023-07-01,5605,5883,278,41.7
1159,2023-07-01,2023-07-31,5883,6343,460,69.0
1159,2023-08-01,2023-08-31,6343,6753,410,61.5
1159,2023-09-01,2023-10-01,6753,6883,130,19.5
1159,2023-10-01,2023-10-31,6883,7361,478,71.7
1159,2023-11-01,2023-12-01,7361,7653,292,43.8
1159,2023-12-01,2023-12-31,7653,7881,228,34.2
1160,2023-01-01,2023-01-31,4192,4416,224,33.6
1160,2023-02-01,2023-03-03,4416,4856,440,66.0
1160,2023-03-01,2023-03-31,4856,4920,64,9.6
1160,2023-04-01,2023-05-01,4920,5183,263,39.45
1160,2023-05-01,2023-05-31,5183,5264,81,12.15
1160,2023-06-01,2023-07-01,5264,5385,121,18.15
1160,2023-07-01,2023-07-31,5385,5614,229,34.35
1160,2023-08-01,2023-08-31,5614,5952,338,50.7
1160,2023-09-01,2023-10-01,5952,6402,450,67.5
1160,2023-10-01,2023-10-31,6402,6736,334,50.1
1160,2023-11-01,2023-12-01,6736,6993,257,38.55
1160,2023-12-01,2023-12-31,6993,7097,104,15.6
1161,2023-01-01,2023-01-31,1343,1469,126,18.9
1161,2023-02-01,2023-03-03,1469,1876,407,61.05
1161,2023-03-01,2023-03-31,1876,2213,337,50.55
1161,2023-04-01,2023-05-01,2213,2612,399,59.85
1161,2023-05-01,2023-05-31,2612,2746,134,20.1
1161,2023-06-01,2023-07-01,2746,2952,206,30.9
1161,2023-07-01,2023-07-31,2952,3335,383,57.45
1161,2023-08-01,2023-08-31,3335,3471,136,20.4
1161,2023-09-01,2023-10-01,3471,3762,291,43.65
1161,2023-10-01,2023-10-31,3762,4048,286,42.9
1161,2023-11-01,2023-12-01,4048,4349,301,45.15
1161,2023-12-01,2023-12-31,4349,4624,275,41.25
1162,2023-01-01,2023-01-31,1067,1320,253,37.95
1162,2023-02-01,2023-03-03,1320,1538,218,32.7
1162,2023-03-01,2023-03-31,1538,1872,334,50.1
1162,2023-04-01,2023-05-01,1872,2305,433,64.95
1162,2023-05-01,2023-05-31,2305,2634,329,49.35
1162,2023-06-01,2023-07-01,2634,2769,135,20.25
1162,2023-07-01,2023-07-31,2769,2994,225,33.75
1162,2023-08-01,2023-08-31,2994,3072,78,11.7
1162,2023-09-01,2023-10-01,3072,3343,271,40.65
1162,2023-10-01,2023-10-31,3343,3439,96,14.4
1162,2023-11-01,2023-12-01,3439,3535,96,14.4
1162,2023-12-01,2023-12-31,3535,3896,361,54.15
1163,2023-01-01,2023-01-31,2640,2983,343,51.45
1163,2023-02-01,2023-03-03,2983,3380,397,59.55
1163,2023-03-01,2023-03-31,3380,3847,467,70.05
1163,2023-04-01,2023-05-01,3847,3927,80,12.0
1163,2023-05-01,2023-05-31,3927,4260,333,49.95
1163,2023-06-01,2023-07-01,4260,4320,60,9.0
1163,2023-07-01,2023-07-31,4320,4661,341,51.15
1163,2023-08-01,2023-08-31,4661,4725,64,9.6
1163,2023-09-01,2023-10-01,4725,5097,372,55.8
1163,2023-10-01,2023-10-31,5097,5164,67,10.05
1163,2023-11-01,2023-12-01,5164,5371,207,31.05
1163,2023-12-01,2023-12-31,5371,5865,494,74.1
1164,2023-01-01,2023-01-31,2913,3093,180,27.0
1164,2023-02-01,2023-03-03,3093,3198,105,15.75
1164,2023-03-01,2023-03-31,3198,3632,434,65.1
1164,2023-04-01,2023-05-01,3632,3704,72,10.8
1164,2023-05-01,2023-05-31,3704,4139,435,65.25
1164,2023-06-01,2023-07-01,4139,4526,387,58.05
1164,2023-07-01,2023-07-31,4526,4924,398,59.7
1164,2023-08-01,2023-08-31,4924,5412,488,73.2
1164,2023-09-01,2023-10-01,5412,5566,154,23.1
1164,2023-10-01,2023-10-31,5566,6056,490,73.5
1164,2023-11-01,2023-12-01,6056,6274,218,32.7
1164,2023-12-01,2023-12-31,6274,6505,231,34.65
1165,2023-01-01,2023-01-31,4081,4131,50,7.5
1165,2023-02-01,2023-03-03,4131,4596,465,69.75
1165,2023-03-01,2023-03-31,4596,5089,493,73.95
1165,2023-04-01,2023-05-01,5089,5168,79,11.85
1165,2023-05-01,2023-05-31,5168,5635,467,70.05
1165,2023-06-01,2023-07-01,5635,5843,208,31.2
1165,2023-07-01,2023-07-31,5843,6149,306,45.9
1165,2023-08-01,2023-08-31,6149,6301,152,22.8
1165,2023-09-01,2023-10-01,6301,6634,333,49.95
1165,2023-10-01,2023-10-31,6634,6956,322,48.3
1165,2023-11-01,2023-12-01,6956,7074,118,17.7
1165,2023-12-01,2023-12-31,7074,7440,366,54.9
1166,2023-01-01,2023-01-31,1234,1563,329,49.35
1166,2023-02-01,2023-03-03,1563,1926,363,54.45
1166,2023-03-01,2023-03-31,1926,2239,313,46.95
1166,2023-04-01,2023-05-01,2239,2341,102,15.3
1166,2023-05-01,2023-05-31,2341,2716,375,56.25
1166,2023-06-01,2023-07-01,2716,3066,350,52.5
1166,2023-07-01,2023-07-31,3066,3242,176,26.4
1166,2023-08-01,2023-08-31,3242,3585,343,51.45
1166,2023-09-01,2023-10-01,3585,3693,108,16.2
1166,2023-10-01,2023-10-31,3693,3796,103,15.45
1166,2023-11-01,2023-12-01,3796,4150,354,53.1
1166,2023-12-01,2023-12-31,4150,4373,223,33.45
1167,2023-01-01,2023-01-31,4209,4650,441,66.15
1167,2023-02-01,2023-03-03,4650,4987,337,50.55
1167,2023-03-01,2023-03-31,4987,5300,313,46.95
1167,2023-04-01,2023-05-01,5300,5749,449,67.35
1167,2023-05-01,2023-05-31,5749,5849,100,15.0
1167,2023-06-01,2023-07-01,5849,6065,216,32.4
1167,2023-07-01,2023-07-31,6065,6296,231,34.65
1167,2023-08-01,2023-08-31,6296,6503,207,31.05
1167,2023-09-01,2023-10-01,6503,7003,500,75.0
1167,2023-10-01,2023-10-31,7003,7308,305,45.75
1167,2023-11-01,2023-12-01,7308,7399,91,13.65
1167,2023-12-01,2023-12-31,7399,7671,272,40.8
1168,2023-01-01,2023-01-31,2248,2447,199,29.85
1168,2023-02-01,2023-03-03,2447,2655,208,31.2
1168,2023-03-01,2023-03-31,2655,2946,291,43.65
1168,2023-04-01,2023-05-01,2946,3349,403,60.45
1168,2023-05-01,2023-05-31,3349,3609,260,39.0
1168,2023-06-01,2023-07-01,3609,3970,361,54.15
1168,2023-07-01,2023-07-31,3970,4038,68,10.2
1168,2023-08-01,2023-08-31,4038,4214,176,26.4
1168,2023-09-01,2023-10-01,4214,4646,432,64.8
1168,2023-10-01,2023-10-31,4646,4910,264,39.6
1168,2023-11-01,2023-12-01,4910,4976,66,9.9
1168,2023-12-01,2023-12-31,4976,5315,339,50.85
1169,2023-01-01,2023-01-31,2300,2740,440,66.0
1169,2023-02-01,2023-03-03,2740,2891,151,22.65
1169,2023-03-01,2023-03-31,2891,3332,441,66.15
1169,2023-04-01,2023-05-01,3332,3501,169,25.35
1169,2023-05-01,2023-05-31,3501,3653,152,22.8
1169,2023-06-01,2023-07-01,3653,3996,343,51.45
1169,2023-07-01,2023-07-31,3996,4323,327,49.05
1169,2023-08-01,2023-08-31,4323,4778,455,68.25
1169,2023-09-01,2023-10-01,4778,4897,119,17.85
1169,2023-10-01,2023-10-31,4897,5059,162,24.3
1169,2023-11-01,2023-12-01,5059,5141,82,12.3
1169,2023-12-01,2023-12-31,5141,5195,54,8.1
1170,2023-01-01,2023-01-31,1765,2129,364,54.6
1170,2023-02-01,2023-03-03,2129,2485,356,53.4
1170,2023-03-01,2023-03-31,2485,2587,102,15.3
1170,2023-04-01,2023-05-01,2587,2723,136,20.4
1170,2023-05-01,2023-05-31,2723,2838,115,17.25
1170,2023-06-01,2023-07-01,2838,3042,204,30.6
1170,2023-07-01,2023-07-31,3042,3122,80,12.0
1170,2023-08-01,2023-08-31,3122,3563,441,66.15
1170,2023-09-01,2023-10-01,3563,3754,191,28.65
1170,2023-10-01,2023-10-31,3754,4034,280,42.0
1170,2023-11-01,2023-12-01,4034,4445,411,61.65
1170,2023-12-01,2023-12-31,4445,4511,66,9.9
1171,2023-01-01,2023-01-31,4687,5079,392,58.8
1171,2023-02-01,2023-03-03,5079,5266,187,28.05
1171,2023-03-01,2023-03-31,5266,5676,410,61.5
1171,2023-04-01,2023-05-01,5676,5845,169,25.35
1171,2023-05-01,2023-05-31,5845,6253,408,61.2
1171,2023-06-01,2023-07-01,6253,6677,424,63.6
1171,2023-07-01,2023-07-31,6677,6893,216,32.4
1171,2023-08-01,2023-08-31,6893,7113,220,33.0
1171,2023-09-01,2023-10-01,7113,7425,312,46.8
1171,2023-10-01,2023-10-31,7425,7608,183,27.45
1171,2023-11-01,2023-12-01,7608,7790,182,27.3
1171,2023-12-01,2023-12-31,7790,8056,266,39.9
1172,2023-01-01,2023-01-31,3323,3557,234,35.1
1172,2023-02-01,2023-03-03,3557,4004,447,67.05
1172,2023-03-01,2023-03-31,4004,4100,96,14.4
1172,2023-04-01,2023-05-01,4100,4358,258,38.7
1172,2023-05-01,2023-05-31,4358,4814,456,68.4
1172,2023-06-01,2023-07-01,4814,5106,292,43.8
1172,2023-07-01,2023-07-31,5106,5450,344,51.6
1172,2023-08-01,2023-08-31,5450,5874,424,63.6
1172,2023-09-01,2023-10-01,5874,6238,364,54.6
1172,2023-10-01,2023-10-31,6238,6648,410,61.5
1172,2023-11-01,2023-12-01,6648,6796,148,22.2
1172,2023-12-01,2023-12-31,6796,7208,412,61.8
1173,2023-01-01,2023-01-31,2075,2128,53,7.95
1173,2023-02-01,2023-03-03,2128,2271,143,21.45
1173,2023-03-01,2023-03-31,2271,2450,179,26.85
1173,2023-04-01,2023-05-01,2450,2901,451,67.65
1173,2023-05-01,2023-05-31,2901,2976,75,11.25
1173,2023-06-01,2023-07-01,2976,3194,218,32.7
1173,2023-07-01,2023-07-31,3194,3510,316,47.4
1173,2023-08-01,2023-08-31,3510,3905,395,59.25
1173,2023-09-01,2023-10-01,3905,3971,66,9.9
1173,2023-10-01,2023-10-31,3971,4140,169,25.35
1173,2023-11-01,2023-12-01,4140,4535,395,59.25
1173,2023-12-01,2023-12-31,4535,4863,328,49.2
1174,2023-01-01,2023-01-31,3075,3446,371,55.65
1174,2023-02-01,2023-03-03,3446,3577,131,19.65
1174,2023-03-01,2023-03-31,3577,3717,140,21.0
1174,2023-04-01,2023-05-01,3717,4092,375,56.25
1174,2023-05-01,2023-05-31,4092,4525,433,64.95
1174,2023-06-01,2023-07-01,4525,4671,146,21.9
1174,2023-07-01,2023-07-31,4671,5136,465,69.75
1174,2023-08-01,2023-08-31,5136,5452,316,47.4
1174,2023-09-01,2023-10-01,5452,5878,426,63.9
1174,2023-10-01,2023-10-31,5878,6079,201,30.15
1174,2023-11-01,2023-12-01,6079,6447,368,55.2
1174,2023-12-01,2023-12-31,6447,6532,85,12.75
1175,2023-01-01,2023-01-31,1281,1488,207,31.05
1175,2023-02-01,2023-03-03,1488,1606,118,17.7
1175,2023-03-01,2023-03-31,1606,2023,417,62.55
1175,2023-04-01,2023-05-01,2023,2271,248,37.2
1175,2023-05-01,2023-05-31,2271,2379,108,16.2
1175,2023-06-01,2023-07-01,2379,2561,182,27.3
1175,2023-07-01,2023-07-31,2561,2838,277,41.55
1175,2023-08-01,2023-08-31,2838,2978,140,21.0
1175,2023-09-01,2023-10-01,2978,3181,203,30.45
1175,2023-10-01,2023-10-31,3181,3458,277,41.55
1175,2023-11-01,2023-12-01,3458,3524,66,9.9
1175,2023-12-01,2023-12-31,3524,3880,356,53.4
1176,2023-01-01,2023-01-31,3140,3602,462,69.3
1176,2023-02-01,2023-03-03,3602,4061,459,68.85
1176,2023-03-01,2023-03-31,4061,4449,388,58.2
1176,2023-04-01,2023-05-01,4449,4908,459,68.85
1176,2023-05-01,2023-05-31,4908,5284,376,56.4
1176,2023-06-01,2023-07-01,5284,5446,162,24.3
1176,2023-07-01,2023-07-31,5446,5539,93,13.95
1176,2023-08-01,2023-08-31,5539,5662,123,18.45
1176,2023-09-01,2023-10-01,5662,6122,460,69.0
1176,2023-10-01,2023-10-31,6122,6193,71,10.65
1176,2023-11-01,2023-12-01,6193,6520,327,49.05
1176,2023-12-01,2023-12-31,6520,6870,350,52.5
1177,2023-01-01,2023-01-31,2851,2932,81,12.15
1177,2023-02-01,2023-03-03,2932,3013,81,12.15
1177,2023-03-01,2023-03-31,3013,3453,440,66.0
1177,2023-04-01,2023-05-01,3453,3943,490,73.5
1177,2023-05-01,2023-05-31,3943,4290,347,52.05
1177,2023-06-01,2023-07-01,4290,4664,374,56.1
1177,2023-07-01,2023-07-31,4664,4877,213,31.95
1177,2023-08-01,2023-08-31,4877,5314,437,65.55
1177,2023-09-01,2023-10-01,5314,5584,270,40.5
1177,2023-10-01,2023-10-31,5584,5989,405,60.75
1177,2023-11-01,2023-12-01,5989,6450,461,69.15
1177,2023-12-01,2023-12-31,6450,6939,489,73.35
1178,2023-01-01,2023-01-31,2818,3242,424,63.6
1178,2023-02-01,2023-03-03,3242,3380,138,20.7
1178,2023-03-01,2023-03-31,3380,3849,469,70.35
1178,2023-04-01,2023-05-01,3849,4017,168,25.2
1178,2023-05-01,2023-05-31,4017,4511,494,74.1
1178,2023-06-01,2023-07-01,4511,4668,157,23.55
1178,2023-07-01,2023-07-31,4668,5024,356,53.4
1178,2023-08-01,2023-08-31,5024,5251,227,34.05
1178,2023-09-01,2023-10-01,5251,5471,220,33.0
1178,2023-10-01,2023-10-31,5471,5521,50,7.5
1178,2023-11-01,2023-12-01,5521,5739,218,32.7
1178,2023-12-01,2023-12-31,5739,6149,410,61.5
1179,2023-01-01,2023-01-31,2582,2971,389,58.35
1179,2023-02-01,2023-03-03,2971,3194,223,33.45
1179,2023-03-01,2023-03-31,3194,3613,419,62.85
1179,2023-04-01,2023-05-01,3613,3746,133,19.95
1179,2023-05-01,2023-05-31,3746,3813,67,10.05
1179,2023-06-01,2023-07-01,3813,3885,72,10.8
1179,2023-07-01,2023-07-31,3885,3960,75,11.25
1179,2023-08-01,2023-08-31,3960,4256,296,44.4
1179,2023-09-01,2023-10-01,4256,4406,150,22.5
1179,2023-10-01,2023-10-31,4406,4495,89,13.35
1179,2023-11-01,2023-12-01,4495,4717,222,33.3
1179,2023-12-01,2023-12-31,4717,4821,104,15.6
1180,2023-01-01,2023-01-31,1506,1757,251,37.65
1180,2023-02-01,2023-03-03,1757,1951,194,29.1
1180,2023-03-01,2023-03-31,1951,2013,62,9.3
1180,2023-04-01,2023-05-01,2013,2312,299,44.85
1180,2023-05-01,2023-05-31,2312,2671,359,53.85
1180,2023-06-01,2023-07-01,2671,2881,210,31.5
1180,2023-07-01,2023-07-31,2881,3228,347,52.05
1180,2023-08-01,2023-08-31,3228,3545,317,47.55
1180,2023-09-01,2023-10-01,3545,3713,168,25.2
1180,2023-10-01,2023-10-31,3713,3919,206,30.9
1180,2023-11-01,2023-12-01,3919,4012,93,13.95
1180,2023-12-01,2023-12-31,4012,4471,459,68.85
1181,2023-01-01,2023-01-31,2249,2510,261,39.15
1181,2023-02-01,2023-03-03,2510,2654,144,21.6
1181,2023-03-01,2023-03-31,2654,2793,139,20.85
1181,2023-04-01,2023-05-01,2793,3065,272,40.8
1181,2023-05-01,2023-05-31,3065,3402,337,50.55
1181,2023-06-01,2023-07-01,3402,3844,442,66.3
1181,2023-07-01,2023-07-31,3844,3950,106,15.9
1181,2023-08-01,2023-08-31,3950,4073,123,18.45
1181,2023-09-01,2023-10-01,4073,4232,159,23.85
1181,2023-10-01,2023-10-31,4232,4406,174,26.1
1181,2023-11-01,2023-12-01,4406,4842,436,65.4
1181,2023-12-01,2023-12-31,4842,5085,243,36.45
1182,2023-01-01,2023-01-31,1611,1975,364,54.6
1182,2023-02-01,2023-03-03,1975,2143,168,25.2
1182,2023-03-01,2023-03-31,2143,2503,360,54.0
1182,2023-04-01,2023-05-01,2503,2819,316,47.4
1182,2023-05-01,2023-05-31,2819,2939,120,18.0
1182,2023-06-01,2023-07-01,2939,3315,376,56.4
1182,2023-07-01,2023-07-31,3315,3484,169,25.35
1182,2023-08-01,2023-08-31,3484,3982,498,74.7
1182,2023-09-01,2023-10-01,3982,4344,362,54.3
1182,2023-10-01,2023-10-31,4344,4516,172,25.8
1182,2023-11-01,2023-12-01,4516,4829,313,46.95
1182,2023-12-01,2023-12-31,4829,4948,119,17.85
1183,2023-01-01,2023-01-31,2130,2546,416,62.4
1183,2023-02-01,2023-03-03,2546,2823,277,41.55
1183,2023-03-01,2023-03-31,2823,3062,239,35.85
1183,2023-04-01,2023-05-01,3062,3159,97,14.55
1183,2023-05-01,2023-05-31,3159,3251,92,13.8
1183,2023-06-01,2023-07-01,3251,3618,367,55.05
1183,2023-07-01,2023-07-31,3618,4087,469,70.35
1183,2023-08-01,2023-08-31,4087,4465,378,56.7
1183,2023-09-01,2023-10-01,4465,4805,340,51.0
1183,2023-10-01,2023-10-31,4805,5202,397,59.55
1183,2023-11-01,2023-12-01,5202,5571,369,55.35
1183,2023-12-01,2023-12-31,5571,5895,324,48.6
1184,2023-01-01,2023-01-31,1338,1695,357,53.55
1184,2023-02-01,2023-03-03,1695,1745,50,7.5
1184,2023-03-01,2023-03-31,1745,2034,289,43.35
1184,2023-04-01,2023-05-01,2034,2462,428,64.2
1184,2023-05-01,2023-05-31,2462,2789,327,49.05
1184,2023-06-01,2023-07-01,2789,2849,60,9.0
1184,2023-07-01,2023-07-31,2849,3040,191,28.65
1184,2023-08-01,2023-08-31,3040,3120,80,12.0
1184,2023-09-01,2023-10-01,3120,3368,248,37.2
1184,2023-10-01,2023-10-31,3368,3507,139,20.85
1184,2023-11-01,2023-12-01,3507,3949,442,66.3
1184,2023-12-01,2023-12-31,3949,4431,482,72.3
1185,2023-01-01,2023-01-31,4172,4369,197,29.55
1185,2023-02-01,2023-03-03,4369,4528,159,23.85
1185,2023-03-01,2023-03-31,4528,4791,263,39.45
1185,2023-04-01,2023-05-01,4791,5218,427,64.05
1185,2023-05-01,2023-05-31,5218,5651,433,64.95
1185,2023-06-01,2023-07-01,5651,5755,104,15.6
1185,2023-07-01,2023-07-31,5755,6211,456,68.4
1185,2023-08-01,2023-08-31,6211,6313,102,15.3
1185,2023-09-01,2023-10-01,6313,6647,334,50.1
1185,2023-10-01,2023-10-31,6647,6776,129,19.35
1185,2023-11-01,2023-12-01,6776,6931,155,23.25
1185,2023-12-01,2023-12-31,6931,7099,168,25.2
1186,2023-01-01,2023-01-31,4776,5217,441,66.15
1186,2023-02-01,2023-03-03,5217,5514,297,44.55
1186,2023-03-01,2023-03-31,5514,5890,376,56.4
1186,2023-04-01,2023-05-01,5890,5952,62,9.3
1186,2023-05-01,2023-05-31,5952,6434,482,72.3
1186,2023-06-01,2023-07-01,6434,6518,84,12.6
1186,2023-07-01,2023-07-31,6518,7002,484,72.6
1186,2023-08-01,2023-08-31,7002,7159,157,23.55
1186,2023-09-01,2023-10-01,7159,7537,378,56.7
1186,2023-10-01,2023-10-31,7537,7862,325,48.75
1186,2023-11-01,2023-12-01,7862,8298,436,65.4
1186,2023-12-01,2023-12-31,8298,8515,217,32.55
1187,2023-01-01,2023-01-31,3041,3541,500,75.0
1187,2023-02-01,2023-03-03,3541,4022,481,72.15
1187,2023-03-01,2023-03-31,4022,4409,387,58.05
1187,2023-04-01,2023-05-01,4409,4886,477,71.55
1187,2023-05-01,2023-05-31,4886,5380,494,74.1
1187,2023-06-01,2023-07-01,5380,5431,51,7.65
1187,2023-07-01,2023-07-31,5431,5872,441,66.15
1187,2023-08-01,2023-08-31,5872,5937,65,9.75
1187,2023-09-01,2023-10-01,5937,6247,310,46.5
1187,2023-10-01,2023-10-31,6247,6450,203,30.45
1187,2023-11-01,2023-12-01,6450,6609,159,23.85
1187,2023-12-01,2023-12-31,6609,6712,103,15.45
1188,2023-01-01,2023-01-31,2029,2404,375,56.25
1188,2023-02-01,2023-03-03,2404,2852,448,67.2
1188,2023-03-01,2023-03-31,2852,3178,326,48.9
1188,2023-04-01,2023-05-01,3178,3292,114,17.1
1188,2023-05-01,2023-05-31,3292,3420,128,19.2
1188,2023-06-01,2023-07-01,3420,3539,119,17.85
1188,2023-07-01,2023-07-31,3539,3883,344,51.6
1188,2023-08-01,2023-08-31,3883,3947,64,9.6
1188,2023-09-01,2023-10-01,3947,4214,267,40.05
1188,2023-10-01,2023-10-31,4214,4680,466,69.9
1188,2023-11-01,2023-12-01,4680,4795,115,17.25
1188,2023-12-01,2023-12-31,4795,4913,118,17.7
1189,2023-01-01,2023-01-31,4142,4308,166,24.9
1189,2023-02-01,2023-03-03,4308,4447,139,20.85
1189,2023-03-01,2023-03-31,4447,4695,248,37.2
1189,2023-04-01,2023-05-01,4695,5150,455,68.25
1189,2023-05-01,2023-05-31,5150,5206,56,8.4
1189,2023-06-01,2023-07-01,5206,5612,406,60.9
1189,2023-07-01,2023-07-31,5612,5798,186,27.9
1189,2023-08-01,2023-08-31,5798,6120,322,48.3
1189,2023-09-01,2023-10-01,6120,6366,246,36.9
1189,2023-10-01,2023-10-31,6366,6664,298,44.7
1189,2023-11-01,2023-12-01,6664,7002,338,50.7
1189,2023-12-01,2023-12-31,7002,7070,68,10.2
1190,2023-01-01,2023-01-31,1554,1805,251,37.65
1190,2023-02-01,2023-03-03,1805,1915,110,16.5
1190,2023-03-01,2023-03-31,1915,1990,75,11.25
1190,2023-04-01,2023-05-01,1990,2083,93,13.95
1190,2023-05-01,2023-05-31,2083,2305,222,33.3
1190,2023-06-01,2023-07-01,2305,2538,233,34.95
1190,2023-07-01,2023-07-31,2538,2660,122,18.3
1190,2023-08-01,2023-08-31,2660,3021,361,54.15
1190,2023-09-01,2023-10-01,3021,3081,60,9.0
1190,2023-10-01,2023-10-31,3081,3220,139,20.85
1190,2023-11-01,2023-12-01,3220,3512,292,43.8
1190,2023-12-01,2023-12-31,3512,3979,467,70.05
1191,2023-01-01,2023-01-31,1065,1409,344,51.6
1191,2023-02-01,2023-03-03,1409,1539,130,19.5
1191,2023-03-01,2023-03-31,1539,1894,355,53.25
1191,2023-04-01,2023-05-01,1894,2279,385,57.75
1191,2023-05-01,2023-05-31,2279,2511,232,34.8
1191,2023-06-01,2023-07-01,2511,2710,199,29.85
1191,2023-07-01,2023-07-31,2710,2904,194,29.1
1191,2023-08-01,2023-08-31,2904,3221,317,47.55
1191,2023-09-01,2023-10-01,3221,3450,229,34.35
1191,2023-10-01,2023-10-31,3450,3518,68,10.2
1191,2023-11-01,2023-12-01,3518,3886,368,55.2
1191,2023-12-01,2023-12-31,3886,4091,205,30.75
1192,2023-01-01,2023-01-31,1075,1356,281,42.15
1192,2023-02-01,2023-03-03,1356,1455,99,14.85
1192,2023-03-01,2023-03-31,1455,1906,451,67.65
1192,2023-04-01,2023-05-01,1906,1980,74,11.1
1192,2023-05-01,2023-05-31,1980,2147,167,25.05
1192,2023-06-01,2023-07-01,2147,2344,197,29.55
1192,2023-07-01,2023-07-31,2344,2789,445,66.75
1192,2023-08-01,2023-08-31,2789,3266,477,71.55
1192,2023-09-01,2023-10-01,3266,3544,278,41.7
1192,2023-10-01,2023-10-31,3544,3891,347,52.05
1192,2023-11-01,2023-12-01,3891,4254,363,54.45
1192,2023-12-01,2023-12-31,4254,4383,129,19.35
1193,2023-01-01,2023-01-31,2616,3032,416,62.4
1193,2023-02-01,2023-03-03,3032,3416,384,57.6
1193,2023-03-01,2023-03-31,3416,3582,166,24.9
1193,2023-04-01,2023-05-01,3582,3877,295,44.25
1193,2023-05-01,2023-05-31,3877,4134,257,38.55
1193,2023-06-01,2023-07-01,4134,4233,99,14.85
1193,2023-07-01,2023-07-31,4233,4520,287,43.05
1193,2023-08-01,2023-08-31,4520,4789,269,40.35
1193,2023-09-01,2023-10-01,4789,4963,174,26.1
1193,2023-10-01,2023-10-31,4963,5441,478,71.7
1193,2023-11-01,2023-12-01,5441,5554,113,16.95
1193,2023-12-01,2023-12-31,5554,5985,431,64.65
1194,2023-01-01,2023-01-31,2549,2825,276,41.4
1194,2023-02-01,2023-03-03,2825,3187,362,54.3
1194,2023-03-01,2023-03-31,3187,3358,171,25.65
1194,2023-04-01,2023-05-01,3358,3797,439,65.85
1194,2023-05-01,2023-05-31,3797,4185,388,58.2
1194,2023-06-01,2023-07-01,4185,4293,108,16.2
1194,2023-07-01,2023-07-31,4293,4555,262,39.3
1194,2023-08-01,2023-08-31,4555,4653,98,14.7
1194,2023-09-01,2023-10-01,4653,5112,459,68.85
1194,2023-10-01,2023-10-31,5112,5431,319,47.85
1194,2023-11-01,2023-12-01,5431,5850,419,62.85
1194,2023-12-01,2023-12-31,5850,6261,411,61.65
1195,2023-01-01,2023-01-31,4375,4760,385,57.75
1195,2023-02-01,2023-03-03,4760,4886,126,18.9
1195,2023-03-01,2023-03-31,4886,5065,179,26.85
1195,2023-04-01,2023-05-01,5065,5427,362,54.3
1195,2023-05-01,2023-05-31,5427,5759,332,49.8
1195,2023-06-01,2023-07-01,5759,6218,459,68.85
1195,2023-07-01,2023-07-31,6218,6312,94,14.1
1195,2023-08-01,2023-08-31,6312,6533,221,33.15
1195,2023-09-01,2023-10-01,6533,7008,475,71.25
1195,2023-10-01,2023-10-31,7008,7238,230,34.5
1195,2023-11-01,2023-12-01,7238,7722,484,72.6
1195,2023-12-01,2023-12-31,7722,8080,358,53.7
1196,2023-01-01,2023-01-31,2429,2789,360,54.0
1196,2023-02-01,2023-03-03,2789,3258,469,70.35
1196,2023-03-01,2023-03-31,3258,3713,455,68.25
1196,2023-04-01,2023-05-01,3713,3947,234,35.1
1196,2023-05-01,2023-05-31,3947,4212,265,39.75
1196,2023-06-01,2023-07-01,4212,4503,291,43.65
1196,2023-07-01,2023-07-31,4503,4792,289,43.35
1196,2023-08-01,2023-08-31,4792,4859,67,10.05
1196,2023-09-01,2023-10-01,4859,5261,402,60.3
1196,2023-10-01,2023-10-31,5261,5595,334,50.1
1196,2023-11-01,2023-12-01,5595,5727,132,19.8
1196,2023-12-01,2023-12-31,5727,5823,96,14.4
1197,2023-01-01,2023-01-31,4397,4832,435,65.25
1197,2023-02-01,2023-03-03,4832,5037,205,30.75
1197,2023-03-01,2023-03-31,5037,5488,451,67.65
1197,2023-04-01,2023-05-01,5488,5885,397,59.55
1197,2023-05-01,2023-05-31,5885,6052,167,25.05
1197,2023-06-01,2023-07-01,6052,6281,229,34.35
1197,2023-07-01,2023-07-31,6281,6524,243,36.45
1197,2023-08-01,2023-08-31,6524,6665,141,21.15
1197,2023-09-01,2023-10-01,6665,6870,205,30.75
1197,2023-10-01,2023-10-31,6870,7332,462,69.3
1197,2023-11-01,2023-12-01,7332,7500,168,25.2
1197,2023-12-01,2023-12-31,7500,7835,335,50.25
1198,2023-01-01,2023-01-31,2444,2786,342,51.3
1198,2023-02-01,2023-03-03,2786,2956,170,25.5
1198,2023-03-01,2023-03-31,2956,3264,308,46.2
1198,2023-04-01,2023-05-01,3264,3708,444,66.6
1198,2023-05-01,2023-05-31,3708,3843,135,20.25
1198,2023-06-01,2023-07-01,3843,4283,440,66.0
1198,2023-07-01,2023-07-31,4283,4654,371,55.65
1198,2023-08-01,2023-08-31,4654,5134,480,72.0
1198,2023-09-01,2023-10-01,5134,5544,410,61.5
1198,2023-10-01,2023-10-31,5544,5928,384,57.6
1198,2023-11-01,2023-12-01,5928,6192,264,39.6
1198,2023-12-01,2023-12-31,6192,6611,419,62.85
1199,2023-01-01,2023-01-31,4838,5124,286,42.9
1199,2023-02-01,2023-03-03,5124,5220,96,14.4
1199,2023-03-01,2023-03-31,5220,5273,53,7.95
1199,2023-04-01,2023-05-01,5273,5418,145,21.75
1199,2023-05-01,2023-05-31,5418,5573,155,23.25
1199,2023-06-01,2023-07-01,5573,6048,475,71.25
1199,2023-07-01,2023-07-31,6048,6414,366,54.9
1199,2023-08-01,2023-08-31,6414,6869,455,68.25
1199,2023-09-01,2023-10-01,6869,6935,66,9.9
1199,2023-10-01,2023-10-31,6935,7209,274,41.1
1199,2023-11-01,2023-12-01,7209,7402,193,28.95
1199,2023-12-01,2023-12-31,7402,7898,496,74.4
1200,2023-01-01,2023-01-31,1742,1973,231,34.65
1200,2023-02-01,2023-03-03,1973,2071,98,14.7
1200,2023-03-01,2023-03-31,2071,2238,167,25.05
1200,2023-04-01,2023-05-01,2238,2726,488,73.2
1200,2023-05-01,2023-05-31,2726,2912,186,27.9
1200,2023-06-01,2023-07-01,2912,3322,410,61.5
1200,2023-07-01,2023-07-31,3322,3422,100,15.0
1200,2023-08-01,2023-08-31,3422,3893,471,70.65
1200,2023-09-01,2023-10-01,3893,4278,385,57.75
1200,2023-10-01,2023-10-31,4278,4734,456,68.4
1200,2023-11-01,2023-12-01,4734,5090,356,53.4
1200,2023-12-01,2023-12-31,5090,5415,325,48.75
1201,2023-01-01,2023-01-31,4634,5029,395,59.25
1201,2023-02-01,2023-03-03,5029,5323,294,44.1
1201,2023-03-01,2023-03-31,5323,5564,241,36.15
1201,2023-04-01,2023-05-01,5564,6017,453,67.95
1201,2023-05-01,2023-05-31,6017,6189,172,25.8
1201,2023-06-01,2023-07-01,6189,6633,444,66.6
1201,2023-07-01,2023-07-31,6633,6784,151,22.65
1201,2023-08-01,2023-08-31,6784,7054,270,40.5
1201,2023-09-01,2023-10-01,7054,7241,187,28.05
1201,2023-10-01,2023-10-31,7241,7305,64,9.6
1201,2023-11-01,2023-12-01,7305,7626,321,48.15
1201,2023-12-01,2023-12-31,7626,8063,437,65.55
1202,2023-01-01,2023-01-31,4606,4952,346,51.9
1202,2023-02-01,2023-03-03,4952,5085,133,19.95
1202,2023-03-01,2023-03-31,5085,5499,414,62.1
1202,2023-04-01,2023-05-01,5499,5934,435,65.25
1202,2023-05-01,2023-05-31,5934,6049,115,17.25
1202,2023-06-01,2023-07-01,6049,6273,224,33.6
1202,2023-07-01,2023-07-31,6273,6434,161,24.15
1202,2023-08-01,2023-08-31,6434,6632,198,29.7
1202,2023-09-01,2023-10-01,6632,6825,193,28.95
1202,2023-10-01,2023-10-31,6825,7260,435,65.25
1202,2023-11-01,2023-12-01,7260,7698,438,65.7
1202,2023-12-01,2023-12-31,7698,7771,73,10.95
1203,2023-01-01,2023-01-31,1136,1216,80,12.0
1203,2023-02-01,2023-03-03,1216,1625,409,61.35
1203,2023-03-01,2023-03-31,1625,1828,203,30.45
1203,2023-04-01,2023-05-01,1828,2077,249,37.35
1203,2023-05-01,2023-05-31,2077,2388,311,46.65
1203,2023-06-01,2023-07-01,2388,2856,468,70.2
1203,2023-07-01,2023-07-31,2856,3189,333,49.95
1203,2023-08-01,2023-08-31,3189,3244,55,8.25
1203,2023-09-01,2023-10-01,3244,3713,469,70.35
1203,2023-10-01,2023-10-31,3713,3943,230,34.5
1203,2023-11-01,2023-12-01,3943,4076,133,19.95
1203,2023-12-01,2023-12-31,4076,4290,214,32.1
1204,2023-01-01,2023-01-31,2913,3378,465,69.75
1204,2023-02-01,2023-03-03,3378,3748,370,55.5
1204,2023-03-01,2023-03-31,3748,3940,192,28.8
1204,2023-04-01,2023-05-01,3940,4262,322,48.3
1204,2023-05-01,2023-05-31,4262,4740,478,71.7
1204,2023-06-01,2023-07-01,4740,4887,147,22.05
1204,2023-07-01,2023-07-31,4887,5326,439,65.85
1204,2023-08-01,2023-08-31,5326,5544,218,32.7
1204,2023-09-01,2023-10-01,5544,5747,203,30.45
1204,2023-10-01,2023-10-31,5747,6024,277,41.55
1204,2023-11-01,2023-12-01,6024,6349,325,48.75
1204,2023-12-01,2023-12-31,6349,6451,102,15.3
1205,2023-01-01,2023-01-31,3753,4145,392,58.8
1205,2023-02-01,2023-03-03,4145,4522,377,56.55
1205,2023-03-01,2023-03-31,4522,4742,220,33.0
1205,2023-04-01,2023-05-01,4742,5196,454,68.1
1205,2023-05-01,2023-05-31,5196,5637,441,66.15
1205,2023-06-01,2023-07-01,5637,5956,319,47.85
1205,2023-07-01,2023-07-31,5956,6116,160,24.0
1205,2023-08-01,2023-08-31,6116,6323,207,31.05
1205,2023-09-01,2023-10-01,6323,6398,75,11.25
1205,2023-10-01,2023-10-31,6398,6702,304,45.6
1205,2023-11-01,2023-12-01,6702,7193,491,73.65
1205,2023-12-01,2023-12-31,7193,7505,312,46.8
1206,2023-01-01,2023-01-31,4346,4528,182,27.3
1206,2023-02-01,2023-03-03,4528,4761,233,34.95
1206,2023-03-01,2023-03-31,4761,4997,236,35.4
1206,2023-04-01,2023-05-01,4997,5070,73,10.95
1206,2023-05-01,2023-05-31,5070,5427,357,53.55
1206,2023-06-01,2023-07-01,5427,5832,405,60.75
1206,2023-07-01,2023-07-31,5832,6034,202,30.3
1206,2023-08-01,2023-08-31,6034,6330,296,44.4
1206,2023-09-01,2023-10-01,6330,6689,359,53.85
1206,2023-10-01,2023-10-31,6689,7135,446,66.9
1206,2023-11-01,2023-12-01,7135,7485,350,52.5
1206,2023-12-01,2023-12-31,7485,7772,287,43.05
1207,2023-01-01,2023-01-31,2689,2939,250,37.5
1207,2023-02-01,2023-03-03,2939,3227,288,43.2
1207,2023-03-01,2023-03-31,3227,3449,222,33.3
1207,2023-04-01,2023-05-01,3449,3733,284,42.6
1207,2023-05-01,2023-05-31,3733,3857,124,18.6
1207,2023-06-01,2023-07-01,3857,3942,85,12.75
1207,2023-07-01,2023-07-31,3942,4361,419,62.85
1207,2023-08-01,2023-08-31,4361,4451,90,13.5
1207,2023-09-01,2023-10-01,4451,4752,301,45.15
1207,2023-10-01,2023-10-31,4752,4927,175,26.25
1207,2023-11-01,2023-12-01,4927,5079,152,22.8
1207,2023-12-01,2023-12-31,5079,5505,426,63.9
1208,2023-01-01,2023-01-31,2940,3346,406,60.9
1208,2023-02-01,2023-03-03,3346,3824,478,71.7
1208,2023-03-01,2023-03-31,3824,4247,423,63.45
1208,2023-04-01,2023-05-01,4247,4692,445,66.75
1208,2023-05-01,2023-05-31,4692,5117,425,63.75
1208,2023-06-01,2023-07-01,5117,5558,441,66.15
1208,2023-07-01,2023-07-31,5558,5973,415,62.25
1208,2023-08-01,2023-08-31,5973,6066,93,13.95
1208,2023-09-01,2023-10-01,6066,6204,138,20.7
1208,2023-10-01,2023-10-31,6204,6509,305,45.75
1208,2023-11-01,2023-12-01,6509,6769,260,39.0
1208,2023-12-01,2023-12-31,6769,7113,344,51.6
1209,2023-01-01,2023-01-31,4982,5408,426,63.9
1209,2023-02-01,2023-03-03,5408,5845,437,65.55
1209,2023-03-01,2023-03-31,5845,5980,135,20.25
1209,2023-04-01,2023-05-01,5980,6034,54,8.1
1209,2023-05-01,2023-05-31,6034,6490,456,68.4
1209,2023-06-01,2023-07-01,6490,6574,84,12.6
1209,2023-07-01,2023-07-31,6574,6780,206,30.9
1209,2023-08-01,2023-08-31,6780,7225,445,66.75
1209,2023-09-01,2023-10-01,7225,7388,163,24.45
1209,2023-10-01,2023-10-31,7388,7626,238,35.7
1209,2023-11-01,2023-12-01,7626,7935,309,46.35
1209,2023-12-01,2023-12-31,7935,8257,322,48.3
1210,2023-01-01,2023-01-31,3111,3245,134,20.1
1210,2023-02-01,2023-03-03,3245,3322,77,11.55
1210,2023-03-01,2023-03-31,3322,3539,217,32.55
1210,2023-04-01,2023-05-01,3539,3976,437,65.55
1210,2023-05-01,2023-05-31,3976,4461,485,72.75
1210,2023-06-01,2023-07-01,4461,4793,332,49.8
1210,2023-07-01,2023-07-31,4793,5067,274,41.1
1210,2023-08-01,2023-08-31,5067,5372,305,45.75
1210,2023-09-01,2023-10-01,5372,5594,222,33.3
1210,2023-10-01,2023-10-31,5594,5695,101,15.15
1210,2023-11-01,2023-12-01,5695,5897,202,30.3
1210,2023-12-01,2023-12-31,5897,6117,220,33.0
1211,2023-01-01,2023-01-31,2339,2801,462,69.3
1211,2023-02-01,2023-03-03,2801,2955,154,23.1
1211,2023-03-01,2023-03-31,2955,3036,81,12.15
1211,2023-04-01,2023-05-01,3036,3222,186,27.9
1211,2023-05-01,2023-05-31,3222,3464,242,36.3
1211,2023-06-01,2023-07-01,3464,3625,161,24.15
1211,2023-07-01,2023-07-31,3625,3839,214,32.1
1211,2023-08-01,2023-08-31,3839,4247,408,61.2
1211,2023-09-01,2023-10-01,4247,4565,318,47.7
1211,2023-10-01,2023-10-31,4565,4759,194,29.1
1211,2023-11-01,2023-12-01,4759,5039,280,42.0
1211,2023-12-01,2023-12-31,5039,5213,174,26.1
1212,2023-01-01,2023-01-31,2197,2486,289,43.35
1212,2023-02-01,2023-03-03,2486,2636,150,22.5
1212,2023-03-01,2023-03-31,2636,2716,80,12.0
1212,2023-04-01,2023-05-01,2716,3208,492,73.8
1212,2023-05-01,2023-05-31,3208,3528,320,48.0
1212,2023-06-01,2023-07-01,3528,3823,295,44.25
1212,2023-07-01,2023-07-31,3823,4294,471,70.65
1212,2023-08-01,2023-08-31,4294,4399,105,15.75
1212,2023-09-01,2023-10-01,4399,4792,393,58.95
1212,2023-10-01,2023-10-31,4792,5254,462,69.3
1212,2023-11-01,2023-12-01,5254,5687,433,64.95
1212,2023-12-01,2023-12-31,5687,6181,494,74.1
1213,2023-01-01,2023-01-31,3115,3340,225,33.75
1213,2023-02-01,2023-03-03,3340,3840,500,75.0
1213,2023-03-01,2023-03-31,3840,4313,473,70.95
1213,2023-04-01,2023-05-01,4313,4638,325,48.75
1213,2023-05-01,2023-05-31,4638,5085,447,67.05
1213,2023-06-01,2023-07-01,5085,5511,426,63.9
1213,2023-07-01,2023-07-31,5511,5917,406,60.9
1213,2023-08-01,2023-08-31,5917,6199,282,42.3
1213,2023-09-01,2023-10-01,6199,6698,499,74.85
1213,2023-10-01,2023-10-31,6698,7118,420,63.0
1213,2023-11-01,2023-12-01,7118,7564,446,66.9
1213,2023-12-01,2023-12-31,7564,8062,498,74.7
1214,2023-01-01,2023-01-31,4572,4974,402,60.3
1214,2023-02-01,2023-03-03,4974,5423,449,67.35
1214,2023-03-01,2023-03-31,5423,5488,65,9.75
1214,2023-04-01,2023-05-01,5488,5605,117,17.55
1214,2023-05-01,2023-05-31,5605,5736,131,19.65
1214,2023-06-01,2023-07-01,5736,6156,420,63.0
1214,2023-07-01,2023-07-31,6156,6303,147,22.05
1214,2023-08-01,2023-08-31,6303,6420,117,17.55
1214,2023-09-01,2023-10-01,6420,6827,407,61.05
1214,2023-10-01,2023-10-31,6827,7257,430,64.5
1214,2023-11-01,2023-12-01,7257,7463,206,30.9
1214,2023-12-01,2023-12-31,7463,7945,482,72.3
1215,2023-01-01,2023-01-31,3166,3225,59,8.85
1215,2023-02-01,2023-03-03,3225,3352,127,19.05
1215,2023-03-01,2023-03-31,3352,3518,166,24.9
1215,2023-04-01,2023-05-01,3518,3803,285,42.75
1215,2023-05-01,2023-05-31,3803,4065,262,39.3
1215,2023-06-01,2023-07-01,4065,4469,404,60.6
1215,2023-07-01,2023-07-31,4469,4730,261,39.15
1215,2023-08-01,2023-08-31,4730,4870,140,21.0
1215,2023-09-01,2023-10-01,4870,5238,368,55.2
1215,2023-10-01,2023-10-31,5238,5659,421,63.15
1215,2023-11-01,2023-12-01,5659,5757,98,14.7
1215,2023-12-01,2023-12-31,5757,5809,52,7.8
1216,2023-01-01,2023-01-31,1246,1660,414,62.1
1216,2023-02-01,2023-03-03,1660,1807,147,22.05
1216,2023-03-01,2023-03-31,1807,1969,162,24.3
1216,2023-04-01,2023-05-01,1969,2294,325,48.75
1216,2023-05-01,2023-05-31,2294,2749,455,68.25
1216,2023-06-01,2023-07-01,2749,3201,452,67.8
1216,2023-07-01,2023-07-31,3201,3527,326,48.9
1216,2023-08-01,2023-08-31,3527,3601,74,11.1
1216,2023-09-01,2023-10-01,3601,3778,177,26.55
1216,2023-10-01,2023-10-31,3778,3880,102,15.3
1216,2023-11-01,2023-12-01,3880,3978,98,14.7
1216,2023-12-01,2023-12-31,3978,4371,393,58.95
1217,2023-01-01,2023-01-31,4205,4613,408,61.2
1217,2023-02-01,2023-03-03,4613,4953,340,51.0
1217,2023-03-01,2023-03-31,4953,5292,339,50.85
1217,2023-04-01,2023-05-01,5292,5605,313,46.95
1217,2023-05-01,2023-05-31,5605,5993,388,58.2
1217,2023-06-01,2023-07-01,5993,6257,264,39.6
1217,2023-07-01,2023-07-31,6257,6497,240,36.0
1217,2023-08-01,2023-08-31,6497,6753,256,38.4
1217,2023-09-01,2023-10-01,6753,6834,81,12.15
1217,2023-10-01,2023-10-31,6834,6997,163,24.45
1217,2023-11-01,2023-12-01,6997,7109,112,16.8
1217,2023-12-01,2023-12-31,7109,7256,147,22.05
1218,2023-01-01,2023-01-31,4824,5076,252,37.8
1218,2023-02-01,2023-03-03,5076,5540,464,69.6
1218,2023-03-01,2023-03-31,5540,5680,140,21.0
1218,2023-04-01,2023-05-01,5680,5776,96,14.4
1218,2023-05-01,2023-05-31,5776,5995,219,32.85
1218,2023-06-01,2023-07-01,5995,6316,321,48.15
1218,2023-07-01,2023-07-31,6316,6611,295,44.25
1218,2023-08-01,2023-08-31,6611,6864,253,37.95
1218,2023-09-01,2023-10-01,6864,7113,249,37.35
1218,2023-10-01,2023-10-31,7113,7214,101,15.15
1218,2023-11-01,2023-12-01,7214,7636,422,63.3
1218,2023-12-01,2023-12-31,7636,7707,71,10.65
1219,2023-01-01,2023-01-31,1729,2159,430,64.5
1219,2023-02-01,2023-03-03,2159,2356,197,29.55
1219,2023-03-01,2023-03-31,2356,2720,364,54.6
1219,2023-04-01,2023-05-01,2720,2983,263,39.45
1219,2023-05-01,2023-05-31,2983,3468,485,72.75
1219,2023-06-01,2023-07-01,3468,3621,153,22.95
1219,2023-07-01,2023-07-31,3621,4113,492,73.8
1219,2023-08-01,2023-08-31,4113,4211,98,14.7
1219,2023-09-01,2023-10-01,4211,4653,442,66.3
1219,2023-10-01,2023-10-31,4653,4984,331,49.65
1219,2023-11-01,2023-12-01,4984,5089,105,15.75
1219,2023-12-01,2023-12-31,5089,5356,267,40.05
1220,2023-01-01,2023-01-31,2078,2272,194,29.1
1220,2023-02-01,2023-03-03,2272,2421,149,22.35
1220,2023-03-01,2023-03-31,2421,2742,321,48.15
1220,2023-04-01,2023-05-01,2742,2950,208,31.2
1220,2023-05-01,2023-05-31,2950,3014,64,9.6
1220,2023-06-01,2023-07-01,3014,3174,160,24.0
1220,2023-07-01,2023-07-31,3174,3651,477,71.55
1220,2023-08-01,2023-08-31,3651,4068,417,62.55
1220,2023-09-01,2023-10-01,4068,4252,184,27.6
1220,2023-10-01,2023-10-31,4252,4443,191,28.65
1220,2023-11-01,2023-12-01,4443,4834,391,58.65
1220,2023-12-01,2023-12-31,4834,5053,219,32.85
1221,2023-01-01,2023-01-31,3369,3789,420,63.0
1221,2023-02-01,2023-03-03,3789,3876,87,13.05
1221,2023-03-01,2023-03-31,3876,4261,385,57.75
1221,2023-04-01,2023-05-01,4261,4395,134,20.1
1221,2023-05-01,2023-05-31,4395,4783,388,58.2
1221,2023-06-01,2023-07-01,4783,5206,423,63.45
1221,2023-07-01,2023-07-31,5206,5517,311,46.65
1221,2023-08-01,2023-08-31,5517,5592,75,11.25
1221,2023-09-01,2023-10-01,5592,5954,362,54.3
1221,2023-10-01,2023-10-31,5954,6348,394,59.1
1221,2023-11-01,2023-12-01,6348,6654,306,45.9
1221,2023-12-01,2023-12-31,6654,6844,190,28.5
1222,2023-01-01,2023-01-31,2517,2628,111,16.65
1222,2023-02-01,2023-03-03,2628,3041,413,61.95
1222,2023-03-01,2023-03-31,3041,3231,190,28.5
1222,2023-04-01,2023-05-01,3231,3498,267,40.05
1222,2023-05-01,2023-05-31,3498,3789,291,43.65
1222,2023-06-01,2023-07-01,3789,3855,66,9.9
1222,2023-07-01,2023-07-31,3855,4319,464,69.6
1222,2023-08-01,2023-08-31,4319,4648,329,49.35
1222,2023-09-01,2023-10-01,4648,5114,466,69.9
1222,2023-10-01,2023-10-31,5114,5304,190,28.5
1222,2023-11-01,2023-12-01,5304,5540,236,35.4
1222,2023-12-01,2023-12-31,5540,5716,176,26.4
1223,2023-01-01,2023-01-31,1489,1707,218,32.7
1223,2023-02-01,2023-03-03,1707,1932,225,33.75
1223,2023-03-01,2023-03-31,1932,2302,370,55.5
1223,2023-04-01,2023-05-01,2302,2491,189,28.35
1223,2023-05-01,2023-05-31,2491,2977,486,72.9
1223,2023-06-01,2023-07-01,2977,3318,341,51.15
1223,2023-07-01,2023-07-31,3318,3426,108,16.2
1223,2023-08-01,2023-08-31,3426,3636,210,31.5
1223,2023-09-01,2023-10-01,3636,3710,74,11.1
1223,2023-10-01,2023-10-31,3710,4072,362,54.3
1223,2023-11-01,2023-12-01,4072,4502,430,64.5
1223,2023-12-01,2023-12-31,4502,4725,223,33.45
1224,2023-01-01,2023-01-31,3725,4082,357,53.55
1224,2023-02-01,2023-03-03,4082,4542,460,69.0
1224,2023-03-01,2023-03-31,4542,5011,469,70.35
1224,2023-04-01,2023-05-01,5011,5237,226,33.9
1224,2023-05-01,2023-05-31,5237,5598,361,54.15
1224,2023-06-01,2023-07-01,5598,5874,276,41.4
1224,2023-07-01,2023-07-31,5874,6202,328,49.2
1224,2023-08-01,2023-08-31,6202,6648,446,66.9
1224,2023-09-01,2023-10-01,6648,6817,169,25.35
1224,2023-10-01,2023-10-31,6817,7270,453,67.95
1224,2023-11-01,2023-12-01,7270,7702,432,64.8
1224,2023-12-01,2023-12-31,7702,8063,361,54.15
1225,2023-01-01,2023-01-31,3376,3478,102,15.3
1225,2023-02-01,2023-03-03,3478,3869,391,58.65
1225,2023-03-01,2023-03-31,3869,4285,416,62.4
1225,2023-04-01,2023-05-01,4285,4637,352,52.8
1225,2023-05-01,2023-05-31,4637,4730,93,13.95
1225,2023-06-01,2023-07-01,4730,5100,370,55.5
1225,2023-07-01,2023-07-31,5100,5582,482,72.3
1225,2023-08-01,2023-08-31,5582,5731,149,22.35
1225,2023-09-01,2023-10-01,5731,5870,139,20.85
1225,2023-10-01,2023-10-31,5870,6138,268,40.2
1225,2023-11-01,2023-12-01,6138,6497,359,53.85
1225,2023-12-01,2023-12-31,6497,6938,441,66.15
1226,2023-01-01,2023-01-31,3705,4015,310,46.5
1226,2023-02-01,2023-03-03,4015,4489,474,71.1
1226,2023-03-01,2023-03-31,4489,4835,346,51.9
1226,2023-04-01,2023-05-01,4835,5199,364,54.6
1226,2023-05-01,2023-05-31,5199,5265,66,9.9
1226,2023-06-01,2023-07-01,5265,5383,118,17.7
1226,2023-07-01,2023-07-31,5383,5742,359,53.85
1226,2023-08-01,2023-08-31,5742,5829,87,13.05
1226,2023-09-01,2023-10-01,5829,6013,184,27.6
1226,2023-10-01,2023-10-31,6013,6407,394,59.1
1226,2023-11-01,2023-12-01,6407,6707,300,45.0
1226,2023-12-01,2023-12-31,6707,7141,434,65.1
1227,2023-01-01,2023-01-31,2740,3154,414,62.1
1227,2023-02-01,2023-03-03,3154,3352,198,29.7
1227,2023-03-01,2023-03-31,3352,3674,322,48.3
1227,2023-04-01,2023-05-01,3674,4106,432,64.8
1227,2023-05-01,2023-05-31,4106,4555,449,67.35
1227,2023-06-01,2023-07-01,4555,5030,475,71.25
1227,2023-07-01,2023-07-31,5030,5189,159,23.85
1227,2023-08-01,2023-08-31,5189,5246,57,8.55
1227,2023-09-01,2023-10-01,5246,5382,136,20.4
1227,2023-10-01,2023-10-31,5382,5578,196,29.4
1227,2023-11-01,2023-12-01,5578,5823,245,36.75
1227,2023-12-01,2023-12-31,5823,6292,469,70.35
1228,2023-01-01,2023-01-31,1663,1727,64,9.6
1228,2023-02-01,2023-03-03,1727,2042,315,47.25
1228,2023-03-01,2023-03-31,2042,2364,322,48.3
1228,2023-04-01,2023-05-01,2364,2729,365,54.75
1228,2023-05-01,2023-05-31,2729,3031,302,45.3
1228,2023-06-01,2023-07-01,3031,3393,362,54.3
1228,2023-07-01,2023-07-31,3393,3887,494,74.1
1228,2023-08-01,2023-08-31,3887,4367,480,72.0
1228,2023-09-01,2023-10-01,4367,4490,123,18.45
1228,2023-10-01,2023-10-31,4490,4803,313,46.95
1228,2023-11-01,2023-12-01,4803,4956,153,22.95
1228,2023-12-01,2023-12-31,4956,5118,162,24.3
1229,2023-01-01,2023-01-31,4051,4451,400,60.0
1229,2023-02-01,2023-03-03,4451,4617,166,24.9
1229,2023-03-01,2023-03-31,4617,5091,474,71.1
1229,2023-04-01,2023-05-01,5091,5580,489,73.35
1229,2023-05-01,2023-05-31,5580,5684,104,15.6
1229,2023-06-01,2023-07-01,5684,6159,475,71.25
1229,2023-07-01,2023-07-31,6159,6568,409,61.35
1229,2023-08-01,2023-08-31,6568,6720,152,22.8
1229,2023-09-01,2023-10-01,6720,7114,394,59.1
1229,2023-10-01,2023-10-31,7114,7284,170,25.5
1229,2023-11-01,2023-12-01,7284,7405,121,18.15
1229,2023-12-01,2023-12-31,7405,7678,273,40.95
1230,2023-01-01,2023-01-31,4684,4967,283,42.45
1230,2023-02-01,2023-03-03,4967,5135,168,25.2
1230,2023-03-01,2023-03-31,5135,5246,111,16.65
1230,2023-04-01,2023-05-01,5246,5618,372,55.8
1230,2023-05-01,2023-05-31,5618,5930,312,46.8
1230,2023-06-01,2023-07-01,5930,6283,353,52.95
1230,2023-07-01,2023-07-31,6283,6591,308,46.2
1230,2023-08-01,2023-08-31,6591,6678,87,13.05
1230,2023-09-01,2023-10-01,6678,7025,347,52.05
1230,2023-10-01,2023-10-31,7025,7090,65,9.75
1230,2023-11-01,2023-12-01,7090,7567,477,71.55
1230,2023-12-01,2023-12-31,7567,7909,342,51.3
1231,2023-01-01,2023-01-31,4264,4401,137,20.55
1231,2023-02-01,2023-03-03,4401,4519,118,17.7
1231,2023-03-01,2023-03-31,4519,4796,277,41.55
1231,2023-04-01,2023-05-01,4796,4867,71,10.65
1231,2023-05-01,2023-05-31,4867,5263,396,59.4
1231,2023-06-01,2023-07-01,5263,5589,326,48.9
1231,2023-07-01,2023-07-31,5589,5989,400,60.0
1231,2023-08-01,2023-08-31,5989,6283,294,44.1
1231,2023-09-01,2023-10-01,6283,6723,440,66.0
1231,2023-10-01,2023-10-31,6723,7108,385,57.75
1231,2023-11-01,2023-12-01,7108,7262,154,23.1
1231,2023-12-01,2023-12-31,7262,7501,239,35.85
1232,2023-01-01,2023-01-31,4400,4795,395,59.25
1232,2023-02-01,2023-03-03,4795,4891,96,14.4
1232,2023-03-01,2023-03-31,4891,5113,222,33.3
1232,2023-04-01,2023-05-01,5113,5294,181,27.15
1232,2023-05-01,2023-05-31,5294,5733,439,65.85
1232,2023-06-01,2023-07-01,5733,6125,392,58.8
1232,2023-07-01,2023-07-31,6125,6425,300,45.0
1232,2023-08-01,2023-08-31,6425,6630,205,30.75
1232,2023-09-01,2023-10-01,6630,6693,63,9.45
1232,2023-10-01,2023-10-31,6693,6973,280,42.0
1232,2023-11-01,2023-12-01,6973,7197,224,33.6
1232,2023-12-01,2023-12-31,7197,7292,95,14.25
1233,2023-01-01,2023-01-31,1080,1337,257,38.55
1233,2023-02-01,2023-03-03,1337,1530,193,28.95
1233,2023-03-01,2023-03-31,1530,1810,280,42.0
1233,2023-04-01,2023-05-01,1810,1942,132,19.8
1233,2023-05-01,2023-05-31,1942,2419,477,71.55
1233,2023-06-01,2023-07-01,2419,2902,483,72.45
1233,2023-07-01,2023-07-31,2902,3095,193,28.95
1233,2023-08-01,2023-08-31,3095,3455,360,54.0
1233,2023-09-01,2023-10-01,3455,3650,195,29.25
1233,2023-10-01,2023-10-31,3650,3960,310,46.5
1233,2023-11-01,2023-12-01,3960,4222,262,39.3
1233,2023-12-01,2023-12-31,4222,4621,399,59.85
1234,2023-01-01,2023-01-31,2673,2886,213,31.95
1234,2023-02-01,2023-03-03,2886,3265,379,56.85
1234,2023-03-01,2023-03-31,3265,3586,321,48.15
1234,2023-04-01,2023-05-01,3586,3752,166,24.9
1234,2023-05-01,2023-05-31,3752,3851,99,14.85
1234,2023-06-01,2023-07-01,3851,4140,289,43.35
1234,2023-07-01,2023-07-31,4140,4604,464,69.6
1234,2023-08-01,2023-08-31,4604,4776,172,25.8
1234,2023-09-01,2023-10-01,4776,5042,266,39.9
1234,2023-10-01,2023-10-31,5042,5094,52,7.8
1234,2023-11-01,2023-12-01,5094,5280,186,27.9
1234,2023-12-01,2023-12-31,5280,5502,222,33.3
1235,2023-01-01,2023-01-31,2778,2919,141,21.15
1235,2023-02-01,2023-03-03,2919,3398,479,71.85
1235,2023-03-01,2023-03-31,3398,3881,483,72.45
1235,2023-04-01,2023-05-01,3881,4021,140,21.0
1235,2023-05-01,2023-05-31,4021,4432,411,61.65
1235,2023-06-01,2023-07-01,4432,4587,155,23.25
1235,2023-07-01,2023-07-31,4587,4817,230,34.5
1235,2023-08-01,2023-08-31,4817,5144,327,49.05
1235,2023-09-01,2023-10-01,5144,5426,282,42.3
1235,2023-10-01,2023-10-31,5426,5868,442,66.3
1235,2023-11-01,2023-12-01,5868,6038,170,25.5
1235,2023-12-01,2023-12-31,6038,6489,451,67.65
1236,2023-01-01,2023-01-31,1820,2189,369,55.35
1236,2023-02-01,2023-03-03,2189,2333,144,21.6
1236,2023-03-01,2023-03-31,2333,2674,341,51.15
1236,2023-04-01,2023-05-01,2674,2957,283,42.45
1236,2023-05-01,2023-05-31,2957,3295,338,50.7
1236,2023-06-01,2023-07-01,3295,3656,361,54.15
1236,2023-07-01,2023-07-31,3656,4114,458,68.7
1236,2023-08-01,2023-08-31,4114,4591,477,71.55
1236,2023-09-01,2023-10-01,4591,4653,62,9.3
1236,2023-10-01,2023-10-31,4653,5028,375,56.25
1236,2023-11-01,2023-12-01,5028,5427,399,59.85
1236,2023-12-01,2023-12-31,5427,5564,137,20.55
1237,2023-01-01,2023-01-31,3165,3435,270,40.5
1237,2023-02-01,2023-03-03,3435,3692,257,38.55
1237,2023-03-01,2023-03-31,3692,3808,116,17.4
1237,2023-04-01,2023-05-01,3808,4135,327,49.05
1237,2023-05-01,2023-05-31,4135,4597,462,69.3
1237,2023-06-01,2023-07-01,4597,4848,251,37.65
1237,2023-07-01,2023-07-31,4848,5119,271,40.65
1237,2023-08-01,2023-08-31,5119,5408,289,43.35
1237,2023-09-01,2023-10-01,5408,5606,198,29.7
1237,2023-10-01,2023-10-31,5606,5735,129,19.35
1237,2023-11-01,2023-12-01,5735,6047,312,46.8
1237,2023-12-01,2023-12-31,6047,6390,343,51.45
1238,2023-01-01,2023-01-31,4572,4745,173,25.95
1238,2023-02-01,2023-03-03,4745,5154,409,61.35
1238,2023-03-01,2023-03-31,5154,5358,204,30.6
1238,2023-04-01,2023-05-01,5358,5720,362,54.3
1238,2023-05-01,2023-05-31,5720,6048,328,49.2
1238,2023-06-01,2023-07-01,6048,6510,462,69.3
1238,2023-07-01,2023-07-31,6510,6761,251,37.65
1238,2023-08-01,2023-08-31,6761,6904,143,21.45
1238,2023-09-01,2023-10-01,6904,7355,451,67.65
1238,2023-10-01,2023-10-31,7355,7604,249,37.35
1238,2023-11-01,2023-12-01,7604,7819,215,32.25
1238,2023-12-01,2023-12-31,7819,8251,432,64.8
1239,2023-01-01,2023-01-31,1574,1648,74,11.1
1239,2023-02-01,2023-03-03,1648,1903,255,38.25
1239,2023-03-01,2023-03-31,1903,2323,420,63.0
1239,2023-04-01,2023-05-01,2323,2690,367,55.05
1239,2023-05-01,2023-05-31,2690,2955,265,39.75
1239,2023-06-01,2023-07-01,2955,3109,154,23.1
1239,2023-07-01,2023-07-31,3109,3407,298,44.7
1239,2023-08-01,2023-08-31,3407,3627,220,33.0
1239,2023-09-01,2023-10-01,3627,3903,276,41.4
1239,2023-10-01,2023-10-31,3903,4391,488,73.2
1239,2023-11-01,2023-12-01,4391,4693,302,45.3
1239,2023-12-01,2023-12-31,4693,4806,113,16.95
1240,2023-01-01,2023-01-31,1768,1975,207,31.05
1240,2023-02-01,2023-03-03,1975,2209,234,35.1
1240,2023-03-01,2023-03-31,2209,2483,274,41.1
1240,2023-04-01,2023-05-01,2483,2656,173,25.95
1240,2023-05-01,2023-05-31,2656,3068,412,61.8
1240,2023-06-01,2023-07-01,3068,3519,451,67.65
1240,2023-07-01,2023-07-31,3519,3765,246,36.9
1240,2023-08-01,2023-08-31,3765,3830,65,9.75
1240,2023-09-01,2023-10-01,3830,4073,243,36.45
1240,2023-10-01,2023-10-31,4073,4471,398,59.7
1240,2023-11-01,2023-12-01,4471,4535,64,9.6
1240,2023-12-01,2023-12-31,4535,4891,356,53.4
1241,2023-01-01,2023-01-31,3213,3520,307,46.05
1241,2023-02-01,2023-03-03,3520,3763,243,36.45
1241,2023-03-01,2023-03-31,3763,3888,125,18.75
1241,2023-04-01,2023-05-01,3888,4372,484,72.6
1241,2023-05-01,2023-05-31,4372,4841,469,70.35
1241,2023-06-01,2023-07-01,4841,5235,394,59.1
1241,2023-07-01,2023-07-31,5235,5304,69,10.35
1241,2023-08-01,2023-08-31,5304,5775,471,70.65
1241,2023-09-01,2023-10-01,5775,6149,374,56.1
1241,2023-10-01,2023-10-31,6149,6554,405,60.75
1241,2023-11-01,2023-12-01,6554,6633,79,11.85
1241,2023-12-01,2023-12-31,6633,6958,325,48.75
1242,2023-01-01,2023-01-31,2520,2860,340,51.0
1242,2023-02-01,2023-03-03,2860,3312,452,67.8
1242,2023-03-01,2023-03-31,3312,3645,333,49.95
1242,2023-04-01,2023-05-01,3645,3997,352,52.8
1242,2023-05-01,2023-05-31,3997,4206,209,31.35
1242,2023-06-01,2023-07-01,4206,4649,443,66.45
1242,2023-07-01,2023-07-31,4649,4941,292,43.8
1242,2023-08-01,2023-08-31,4941,5077,136,20.4
1242,2023-09-01,2023-10-01,5077,5186,109,16.35
1242,2023-10-01,2023-10-31,5186,5516,330,49.5
1242,2023-11-01,2023-12-01,5516,5935,419,62.85
1242,2023-12-01,2023-12-31,5935,6266,331,49.65
1243,2023-01-01,2023-01-31,3750,4172,422,63.3
1243,2023-02-01,2023-03-03,4172,4582,410,61.5
1243,2023-03-01,2023-03-31,4582,4878,296,44.4
1243,2023-04-01,2023-05-01,4878,5343,465,69.75
1243,2023-05-01,2023-05-31,5343,5625,282,42.3
1243,2023-06-01,2023-07-01,5625,5907,282,42.3
1243,2023-07-01,2023-07-31,5907,6254,347,52.05
1243,2023-08-01,2023-08-31,6254,6383,129,19.35
1243,2023-09-01,2023-10-01,6383,6445,62,9.3
1243,2023-10-01,2023-10-31,6445,6933,488,73.2
1243,2023-11-01,2023-12-01,6933,7099,166,24.9
1243,2023-12-01,2023-12-31,7099,7586,487,73.05
1244,2023-01-01,2023-01-31,3461,3533,72,10.8
1244,2023-02-01,2023-03-03,3533,3748,215,32.25
1244,2023-03-01,2023-03-31,3748,3830,82,12.3
1244,2023-04-01,2023-05-01,3830,4274,444,66.6
1244,2023-05-01,2023-05-31,4274,4636,362,54.3
1244,2023-06-01,2023-07-01,4636,4765,129,19.35
1244,2023-07-01,2023-07-31,4765,5009,244,36.6
1244,2023-08-01,2023-08-31,5009,5099,90,13.5
1244,2023-09-01,2023-10-01,5099,5219,120,18.0
1244,2023-10-01,2023-10-31,5219,5429,210,31.5
1244,2023-11-01,2023-12-01,5429,5497,68,10.2
1244,2023-12-01,2023-12-31,5497,5752,255,38.25
1245,2023-01-01,2023-01-31,1441,1779,338,50.7
1245,2023-02-01,2023-03-03,1779,1885,106,15.9
1245,2023-03-01,2023-03-31,1885,2166,281,42.15
1245,2023-04-01,2023-05-01,2166,2379,213,31.95
1245,2023-05-01,2023-05-31,2379,2503,124,18.6
1245,2023-06-01,2023-07-01,2503,2562,59,8.85
1245,2023-07-01,2023-07-31,2562,2826,264,39.6
1245,2023-08-01,2023-08-31,2826,3070,244,36.6
1245,2023-09-01,2023-10-01,3070,3514,444,66.6
1245,2023-10-01,2023-10-31,3514,3758,244,36.6
1245,2023-11-01,2023-12-01,3758,4245,487,73.05
1245,2023-12-01,2023-12-31,4245,4641,396,59.4
1246,2023-01-01,2023-01-31,4206,4265,59,8.85
1246,2023-02-01,2023-03-03,4265,4349,84,12.6
1246,2023-03-01,2023-03-31,4349,4568,219,32.85
1246,2023-04-01,2023-05-01,4568,4642,74,11.1
1246,2023-05-01,2023-05-31,4642,4740,98,14.7
1246,2023-06-01,2023-07-01,4740,4993,253,37.95
1246,2023-07-01,2023-07-31,4993,5300,307,46.05
1246,2023-08-01,2023-08-31,5300,5506,206,30.9
1246,2023-09-01,2023-10-01,5506,5743,237,35.55
1246,2023-10-01,2023-10-31,5743,5882,139,20.85
1246,2023-11-01,2023-12-01,5882,6055,173,25.95
1246,2023-12-01,2023-12-31,6055,6160,105,15.75
1247,2023-01-01,2023-01-31,3810,4022,212,31.8
1247,2023-02-01,2023-03-03,4022,4359,337,50.55
1247,2023-03-01,2023-03-31,4359,4739,380,57.0
1247,2023-04-01,2023-05-01,4739,5034,295,44.25
1247,2023-05-01,2023-05-31,5034,5338,304,45.6
1247,2023-06-01,2023-07-01,5338,5816,478,71.7
1247,2023-07-01,2023-07-31,5816,6140,324,48.6
1247,2023-08-01,2023-08-31,6140,6347,207,31.05
1247,2023-09-01,2023-10-01,6347,6636,289,43.35
1247,2023-10-01,2023-10-31,6636,6877,241,36.15
1247,2023-11-01,2023-12-01,6877,7256,379,56.85
1247,2023-12-01,2023-12-31,7256,7728,472,70.8
1248,2023-01-01,2023-01-31,3685,3737,52,7.8
1248,2023-02-01,2023-03-03,3737,3909,172,25.8
1248,2023-03-01,2023-03-31,3909,3965,56,8.4
1248,2023-04-01,2023-05-01,3965,4415,450,67.5
1248,2023-05-01,2023-05-31,4415,4486,71,10.65
1248,2023-06-01,2023-07-01,4486,4557,71,10.65
1248,2023-07-01,2023-07-31,4557,5006,449,67.35
1248,2023-08-01,2023-08-31,5006,5319,313,46.95
1248,2023-09-01,2023-10-01,5319,5404,85,12.75
1248,2023-10-01,2023-10-31,5404,5458,54,8.1
1248,2023-11-01,2023-12-01,5458,5634,176,26.4
1248,2023-12-01,2023-12-31,5634,5932,298,44.7
1249,2023-01-01,2023-01-31,3155,3212,57,8.55
1249,2023-02-01,2023-03-03,3212,3527,315,47.25
1249,2023-03-01,2023-03-31,3527,3647,120,18.0
1249,2023-04-01,2023-05-01,3647,3872,225,33.75
1249,2023-05-01,2023-05-31,3872,4364,492,73.8
1249,2023-06-01,2023-07-01,4364,4528,164,24.6
1249,2023-07-01,2023-07-31,4528,4860,332,49.8
1249,2023-08-01,2023-08-31,4860,5355,495,74.25
1249,2023-09-01,2023-10-01,5355,5575,220,33.0
1249,2023-10-01,2023-10-31,5575,5658,83,12.45
1249,2023-11-01,2023-12-01,5658,5795,137,20.55
1249,2023-12-01,2023-12-31,5795,6150,355,53.25
1250,2023-01-01,2023-01-31,3903,4032,129,19.35
1250,2023-02-01,2023-03-03,4032,4442,410,61.5
1250,2023-03-01,2023-03-31,4442,4665,223,33.45
1250,2023-04-01,2023-05-01,4665,5035,370,55.5
1250,2023-05-01,2023-05-31,5035,5423,388,58.2
1250,2023-06-01,2023-07-01,5423,5756,333,49.95
1250,2023-07-01,2023-07-31,5756,6060,304,45.6
1250,2023-08-01,2023-08-31,6060,6281,221,33.15
1250,2023-09-01,2023-10-01,6281,6496,215,32.25
1250,2023-10-01,2023-10-31,6496,6752,256,38.4
1250,2023-11-01,2023-12-01,6752,7245,493,73.95
1250,2023-12-01,2023-12-31,7245,7383,138,20.7
